260|a	Geocode Location
[Albany, New York :	Albany, New York
[Albany :	Albany, New York
[Albany? :	Albany, New York
[Albany] :	Albany, New York
Albany,	Albany, New York
Albany, :	Albany, New York
Albany, N.Y.,	Albany, New York
Albany, N.Y.?	Albany, New York
Albany:	Albany, New York
Albany :	Albany, New York
Albany: :	Albany, New York
Albany [N.Y.] :	Albany, New York
Printed at Albany,	Albany, New York
Printed at Albany :	Albany, New York
Alexandria, Va.,	Alexandria, Virginia
Alexandria, Virginia, :	Alexandria, Virginia
Alexandria [Va.] :	Alexandria, Virginia
Alexandria [Va.]: :	Alexandria, Virginia
Amherst [Mass.? :	Amherst, Massachusetts
[Amherst, N.H.] :	Amherst, New Hampshire
Amherst, N.H.,	Amherst, New Hampshire
Amherst, N.H. :	Amherst, New Hampshire
Amherst, Newhampshire, :	Amherst, New Hampshire
Amherst, New Hampshire, :	Amherst, New Hampshire
Amherst, Newhampshire :	Amherst, New Hampshire
Amherst, New Hampshire :	Amherst, New Hampshire
Amherst, New-Hampshire :	Amherst, New Hampshire
Amherst [N.H.] :	Amherst, New Hampshire
Amherst [N.H.]: :	Amherst, New Hampshire
Printed at Amherst [N.H.], :	Amherst, New Hampshire
Printed at Amherst [N.H.] :	Amherst, New Hampshire
Andover [Mass.] :	Andover, Massachusetts
[Annapolis, Md.] :	Annapolis, Maryland
[Annapolis :	Annapolis, Maryland
[Annapolis? :	Annapolis, Maryland
[Annapolis] North-America :	Annapolis, Maryland
Annapolis ,	Annapolis, Maryland
Annapolis :	Annapolis, Maryland
Annapolis [Md.] :	Annapolis, Maryland
Augusta :	Augusta, Georgia
Augusta [Ga.] :	Augusta, Georgia
[Augusta, Me. :	Augusta, Maine
Augusta, (District of Maine) :	Augusta, Maine
Augusta, (Kennebeck) [Me.] :	Augusta, Maine
Augusta, Me. :	Augusta, Maine
[Ballston Spa, N.Y.] :	Ballston, New York
Ballston, Saratoga County [N.Y.]: :	Ballston, New York
Ballston [N.Y.] :	Ballston, New York
[Baltimore,	Baltimore, Maryland
[Baltimore :	Baltimore, Maryland
[Baltimore? :	Baltimore, Maryland
[Baltimore] :	Baltimore, Maryland
[Maryland :	Baltimore, Maryland
A Baltimore :	Baltimore, Maryland
Baltimore	Baltimore, Maryland
Baltimore,	Baltimore, Maryland
Baltimore :	Baltimore, Maryland
Baltimore: :	Baltimore, Maryland
Basseterre, in Saint Christopher :	Basseterre, Saint Kitts-Nevis
Basseterre, St. Christopher's :	Basseterre, Saint Kitts-Nevis
St. Christopher :	Basseterre, Saint Kitts-Nevis
St. Christopher's :	Basseterre, Saint Kitts-Nevis
[Bennington, Vt.]	Bennington, Vermont
[Bennington, Vt.] :	Bennington, Vermont
[Bennington] :	Bennington, Vermont
Bennington,	Bennington, Vermont
Bennington, Vermont :	Bennington, Vermont
Bennington: (Vermont:) :	Bennington, Vermont
Bennington: State of Vermont 	Bennington, Vermont
Bennington: state of Vermont :	Bennington, Vermont
Bennington: State of Vermont  :	Bennington, Vermont
Bennington [Vt.], :	Bennington, Vermont
Bennington [Vt.] :	Bennington, Vermont
Bennington [Vt.]: :	Bennington, Vermont
Printed at Bennington, (Vermont) :	Bennington, Vermont
Printed at Bennington [Vt.], :	Bennington, Vermont
Printed in [Bennington] Vermont :	Bennington, Vermont
Printed in Bennington, (Vermont) :	Bennington, Vermont
Printed in Bennington, Vermont :	Bennington, Vermont
State of Vermont. Printed in Bennington, :	Bennington, Vermont
Birmingham,	Birmingham, Alabama
[Bogot :	Bogota, Colombia
[Bogot] :	Bogota, Colombia
Con licencia en Sta. F [de Bogot] :	Bogota, Colombia
En Sant[a] F de Bogot :	Bogota, Colombia
En Santaf :	Bogota, Colombia
En Santa F de Bogot :	Bogota, Colombia
En Santa F de Bogot :	Bogota, Colombia
En Santa F de Bogot :	Bogota, Colombia
En Santa F de Bogot :	Bogota, Colombia
En Santa F de Bogota :	Bogota, Colombia
En Santa F de Bogota [Colombia] :	Bogota, Colombia
En Santa Fe de Bogot: :	Bogota, Colombia
En Santafe de Bogota: MDCCXCIII :	Bogota, Colombia
En Sta. F de Bogot :	Bogota, Colombia
En Sta F de Bogot :	Bogota, Colombia
En Sta-F de Bogot :	Bogota, Colombia
Publicado en esta Ciudad de Santa F de Bogot :	Bogota, Colombia
[Boston	Boston, Massachusetts
[Boston  	Boston, Massachusetts
[Boston,	Boston, Massachusetts
[Boston, :	Boston, Massachusetts
[Boston, Mass? :	Boston, Massachusetts
[Boston, Mass. :	Boston, Massachusetts
[Boston, Mass.? :	Boston, Massachusetts
[Boston, Mass.] :	Boston, Massachusetts
[Boston, N.E.,	Boston, Massachusetts
[Boston, New-England,	Boston, Massachusetts
[Boston :	Boston, Massachusetts
[Boston: :	Boston, Massachusetts
[Boston?	Boston, Massachusetts
[Boston? :	Boston, Massachusetts
[Boston ? :	Boston, Massachusetts
[Boston? :s.n.,	Boston, Massachusetts
[Boston?] :	Boston, Massachusetts
[Boston (Faust's Statue, No. 45, Newbury Street)] :	Boston, Massachusetts
[Boston]	Boston, Massachusetts
[Boston],	Boston, Massachusetts
[Boston] :	Boston, Massachusetts
[Boston] America :	Boston, Massachusetts
[Boston] America: :	Boston, Massachusetts
[Boston] Commonwealth of Massachusetts :	Boston, Massachusetts
[Boston] Commonwealth of Massachusetts: :	Boston, Massachusetts
[Boston] Mass. :	Boston, Massachusetts
[Boston] New-England :	Boston, Massachusetts
[London] :	Boston, Massachusetts
"[United States] :;""[Boston :"""	Boston, Massachusetts
A Boston :	Boston, Massachusetts
America, Massachusetts-Bay: Boston,	Boston, Massachusetts
America, Massachusetts-Bay: Boston :	Boston, Massachusetts
America: Boston :	Boston, Massachusetts
America: Massachusetts  Boston :	Boston, Massachusetts
America. Boston :	Boston, Massachusetts
America [i.e., Boston] :	Boston, Massachusetts
Boston	Boston, Massachusetts
Boston 	Boston, Massachusetts
Boston  	Boston, Massachusetts
Boston,	Boston, Massachusetts
"Boston,;""[New York,"""	Boston, Massachusetts
"Boston,;""London"""	Boston, Massachusetts
"Boston,;""Newport, Rhode-Island,"""	Boston, Massachusetts
Boston, :	Boston, Massachusetts
Boston, (Commonwealth of Massachusetts.) :	Boston, Massachusetts
Boston, (Commonwealth of Massachusetts) :	Boston, Massachusetts
Boston, [Mass.] :	Boston, Massachusetts
Boston, Commonwealth of Massachusetts: :	Boston, Massachusetts
Boston, in America :	Boston, Massachusetts
Boston, in America: :	Boston, Massachusetts
Boston, in N.E.	Boston, Massachusetts
Boston, in N. E.	Boston, Massachusetts
Boston, in N.E. :	Boston, Massachusetts
Boston, in New-England, :	Boston, Massachusetts
Boston, in New England :	Boston, Massachusetts
Boston, in New-England :	Boston, Massachusetts
Boston, in New-England: :	Boston, Massachusetts
Boston, in NewEngland [sic].	Boston, Massachusetts
Boston, Mass.,	Boston, Massachusetts
Boston, Mass. :	Boston, Massachusetts
Boston, Massachusetts,	Boston, Massachusetts
Boston, Massachusetts :	Boston, Massachusetts
Boston, N.E.	Boston, Massachusetts
Boston, N.E.,	Boston, Massachusetts
Boston, N. E.,	Boston, Massachusetts
Boston, N.E. :	Boston, Massachusetts
Boston, N. England, :	Boston, Massachusetts
Boston, N.N.E. [sic] :	Boston, Massachusetts
Boston, N E. :	Boston, Massachusetts
Boston, New-England 	Boston, Massachusetts
Boston, New England,	Boston, Massachusetts
Boston, New-England,	Boston, Massachusetts
Boston, New England, :	Boston, Massachusetts
Boston, New-England, :	Boston, Massachusetts
Boston, New England :	Boston, Massachusetts
Boston, New-England :	Boston, Massachusetts
Boston, New-England  :	Boston, Massachusetts
Boston, New-England: :	Boston, Massachusetts
Boston, New-England : Printed and sold by Richard Draper, in Newbury-Street, Edes & Gill, in Queen Street, and Thomas & John Fleet in Cornhill.,	Boston, Massachusetts
Boston, printed. :	Boston, Massachusetts
Boston, Printed by D. and J. Kneeland for T. Leverett,	Boston, Massachusetts
"Boston  ;""New-England :"""	Boston, Massachusetts
Boston:	Boston, Massachusetts
Boston: 	Boston, Massachusetts
Boston:  	Boston, Massachusetts
Boston :	Boston, Massachusetts
Boston : 	Boston, Massachusetts
Boston  :	Boston, Massachusetts
"Boston :;""London :"""	Boston, Massachusetts
Boston: :	Boston, Massachusetts
Boston: :bPrinted by Mein and Fleeming, and to be sold by J. Mein, at London Book-store, North-side of King-street.,	Boston, Massachusetts
Boston: (Commonwealth of Massachusetts) :	Boston, Massachusetts
Boston: (Massachusetts) :	Boston, Massachusetts
Boston: (New-England.) :	Boston, Massachusetts
Boston :[T. & J. Fleet,	Boston, Massachusetts
Boston: Commonwealth of Massachusetts, :	Boston, Massachusetts
Boston: in N.E. :	Boston, Massachusetts
Boston: in New-England, :	Boston, Massachusetts
Boston: N:E :	Boston, Massachusetts
Boston: N.E.	Boston, Massachusetts
Boston: N.E.,	Boston, Massachusetts
Boston: N.E. :	Boston, Massachusetts
Boston : N.E.: 	Boston, Massachusetts
Boston : N.E. :	Boston, Massachusetts
Boston: N.E. : Printed and sold by R. Draper in Newbury-Street, and by Edes & Gill, and Green & Russell, in Queen-Street.,	Boston, Massachusetts
Boston: New-England, :	Boston, Massachusetts
Boston : New-England, :	Boston, Massachusetts
Boston: New-England:	Boston, Massachusetts
Boston: New-England :	Boston, Massachusetts
Boston: New-England  :	Boston, Massachusetts
Boston: New-England: :	Boston, Massachusetts
Boston: New-England. :	Boston, Massachusetts
Boston : New England. :	Boston, Massachusetts
Boston: State of Massachusetts-Bay, :	Boston, Massachusetts
Boston: state of Massachusetts-Bay :	Boston, Massachusetts
Boston: State of Massachusetts-Bay :	Boston, Massachusetts
Boston.	Boston, Massachusetts
Boston. :	Boston, Massachusetts
Boston  (Commonwealth of Massachusetts,) :	Boston, Massachusetts
Boston (Massachusetts) :	Boston, Massachusetts
Boston [i.e., New London, Conn.] :	Boston, Massachusetts
Boston [Mass.]	Boston, Massachusetts
Boston [Mass.] :	Boston, Massachusetts
Boston]	Boston, Massachusetts
Boston Commonwealth of Massachusetts :	Boston, Massachusetts
Bostoni, Nov-Anglorum, :	Boston, Massachusetts
Bostoni¾ :	Boston, Massachusetts
Bostoni¾ [Boston] :	Boston, Massachusetts
Bostoniae, Americae :	Boston, Massachusetts
Bostoniae :	Boston, Massachusetts
Bostoniae: :	Boston, Massachusetts
Bostoniae:  :	Boston, Massachusetts
Bostoniae: Nov. Ang. :	Boston, Massachusetts
Bostoni in Nov-Anglia :	Boston, Massachusetts
Bostoni in Nov-Anglia excusum :	Boston, Massachusetts
Bostoni-Massachusettensium :	Boston, Massachusetts
Boston in N.E. :	Boston, Massachusetts
Boston in N. E. :	Boston, Massachusetts
Boston in N.E. [i.e. New England] :	Boston, Massachusetts
Boston in N.E. [New England] :	Boston, Massachusetts
Boston in N.E. printed :	Boston, Massachusetts
Boston in N. England :	Boston, Massachusetts
Boston in N E :	Boston, Massachusetts
Boston in N E. :	Boston, Massachusetts
Boston in New=England :	Boston, Massachusetts
Boston in New-Engiand [sic] :	Boston, Massachusetts
Boston in New-England	Boston, Massachusetts
Boston in New-England,	Boston, Massachusetts
Boston in New-England, :	Boston, Massachusetts
Boston in New England :	Boston, Massachusetts
Boston in New-England:	Boston, Massachusetts
Boston in New-England :	Boston, Massachusetts
Boston in New-England  :	Boston, Massachusetts
Boston  in New-England :	Boston, Massachusetts
Boston in New England: :	Boston, Massachusetts
Boston in New-England: :	Boston, Massachusetts
Boston in New-England.	Boston, Massachusetts
Boston in New-England. :	Boston, Massachusetts
Boston N, E. :	Boston, Massachusetts
Boston  N.E. :	Boston, Massachusetts
Boston  New England, :	Boston, Massachusetts
Boston  New-England, :	Boston, Massachusetts
Boston New-England :	Boston, Massachusetts
Boston  New England:	Boston, Massachusetts
Boston  New-England :	Boston, Massachusetts
Boston  New England: :	Boston, Massachusetts
Boston  New-England: :	Boston, Massachusetts
Boston of the Massachusetts :	Boston, Massachusetts
Boston printed,	Boston, Massachusetts
Boston printed, :	Boston, Massachusetts
Boston printed :	Boston, Massachusetts
Columbia [i.e., Boston] :	Boston, Massachusetts
Columbia [i.e. Boston?] printed. :	Boston, Massachusetts
Commonwealth of Massachusetts, Boston, N.E. :	Boston, Massachusetts
Commonwealth of Massachusetts: Boston, :	Boston, Massachusetts
Commonwealth of Massachusetts: Boston :	Boston, Massachusetts
Commonwealth of Massachusetts: Boston: :	Boston, Massachusetts
Commonwealth of Massachusetts. Boston :	Boston, Massachusetts
Danvers [Mass.], near Boston :	Boston, Massachusetts
Danvers [Mass.], near Boston: :	Boston, Massachusetts
Dublin [i.e., Boston] :	Boston, Massachusetts
Imprim  Boston. :	Boston, Massachusetts
"Lancaster, (Pennsylvania);""Boston,"""	Boston, Massachusetts
"London,;""Boston,"""	Boston, Massachusetts
London [i.e., Boston] :	Boston, Massachusetts
Massachuset, Boston :	Boston, Massachusetts
Massachusetts  Boston, :	Boston, Massachusetts
Massachusetts  Boston :	Boston, Massachusetts
Massachusetts-State: Boston :	Boston, Massachusetts
Massachusetts-state: Boston  :	Boston, Massachusetts
Massachusetts-state. Boston :	Boston, Massachusetts
Massachusetts-State  Boston :	Boston, Massachusetts
New-England, Boston :	Boston, Massachusetts
New England [i.e. Boston] :	Boston, Massachusetts
Philadelphia, printed. Boston :	Boston, Massachusetts
Philadelphia [i.e., Boston?],	Boston, Massachusetts
"Portlamd, ME;""Boston, MA :"""	Boston, Massachusetts
Printed, typographically, at Boston, :	Boston, Massachusetts
Printed, typographically, at Boston :	Boston, Massachusetts
Printed at Boston	Boston, Massachusetts
Printed at Boston,	Boston, Massachusetts
Printed at Boston, :	Boston, Massachusetts
Printed at Boston, (according to act of Congress.) :	Boston, Massachusetts
Printed at Boston, Massachusetts, :	Boston, Massachusetts
Printed at Boston, Massachusetts :	Boston, Massachusetts
"Printed at Boston ;""Repr. Edinb.,"""	Boston, Massachusetts
Printed at Boston :	Boston, Massachusetts
Printed at Boston. :	Boston, Massachusetts
Printed at Boston in N. England :	Boston, Massachusetts
Printed at Boston in New-England, :	Boston, Massachusetts
Printed at Boston in New-England :	Boston, Massachusetts
Printed at the Apollo Press, in Boston :	Boston, Massachusetts
"Printed at Worcester, Massachusetts,;""Sold in Worcester,"";""In Boston"";""In Baltimore,"";""In Albany,"""	Boston, Massachusetts
Printed in Boston,	Boston, Massachusetts
Printed in Boston, :	Boston, Massachusetts
Printed in Boston, 1793. :	Boston, Massachusetts
Printed in Boston, Massachusetts :	Boston, Massachusetts
Printed in Boston, Massachusetts: at the State Press, :	Boston, Massachusetts
Printed in Boston :	Boston, Massachusetts
Printed in Boston. :	Boston, Massachusetts
Printed typographically, at Boston, :	Boston, Massachusetts
Reimprimee a Boston, :	Boston, Massachusetts
Re-printed at Boston in N.E. :	Boston, Massachusetts
State of Massachusetts. Boston: :	Boston, Massachusetts
State of Massachusetts-Bay. Boston :	Boston, Massachusetts
[Me.] :	Bowdoinham, Maine
Bradford, New Hampshire,	Bradford, New Hampshire
Brattleboro' [Vt.]: :	Brattleboro, Vermont
Brattleborough, Vermont: :	Brattleboro, Vermont
Brattleborough [Vt.]: :	Brattleboro, Vermont
Printed at Brattleborough,	Brattleboro, Vermont
Printed at Brattleborough [Vt.] :	Brattleboro, Vermont
Bridgeport [Conn.]: :	Bridgeport, Connecticut
[Bridgetown] :	Bridgetown, Barbados
Barbados :	Bridgetown, Barbados
Barbados [Bridgetown, Barbados?] :	Bridgetown, Barbados
[Bridgewater, Mass. :	Bridgewater, Massachusetts
Bristol,	Bristol, Massachusetts
[Brookfield, Mass.] :	Brookfield, Massachusetts
Brookfield, (Mass.) :	Brookfield, Massachusetts
Brookfield, (Massachusetts:) :	Brookfield, Massachusetts
Brookfield, Mass.,	Brookfield, Massachusetts
Brookfield, Mass. :	Brookfield, Massachusetts
Brookfield: (Massachusetts) :	Brookfield, Massachusetts
Printed at Brookfield, (Massachusetts,) :	Brookfield, Massachusetts
Printed at Brookfield, Mass. :	Brookfield, Massachusetts
Printed at Brookfield, Massachusetts, :	Brookfield, Massachusetts
Printed at Brookfield, Massachusetts :	Brookfield, Massachusetts
Printed at Brookfield (Massachusetts) :	Brookfield, Massachusetts
[Buenos Aires :	Buenos Aires, Argentina
[Buenos Aires :bs.n.,	Buenos Aires, Argentina
[Buenos Aires] :	Buenos Aires, Argentina
[Buenos-Ayres :	Buenos Aires, Argentina
Buenos-Ayres, MDCCLXXXVIII :	Buenos Aires, Argentina
Buenos Ayres :	Buenos Aires, Argentina
Buenos-Ayres :	Buenos Aires, Argentina
Buenos-Ayres: :	Buenos Aires, Argentina
Buenos Ayres. MDCCLXXXI :	Buenos Aires, Argentina
Buenos-Ayres. MDCCLXXXI :	Buenos Aires, Argentina
Buenos-Ayres. MDCCLXXXIII :	Buenos Aires, Argentina
Buenos-Ayres MDCCLXXXIV :	Buenos Aires, Argentina
Buenos-Ayres MDCCLXXXIX :	Buenos Aires, Argentina
Buenos-Ayres MDCCLXXXVIII :	Buenos Aires, Argentina
Buenos-Ayres MDCCXC :	Buenos Aires, Argentina
En Buenos=Ayres :	Buenos Aires, Argentina
En Buenos=Ayres. :	Buenos Aires, Argentina
En Buenosaires [sic] :	Buenos Aires, Argentina
En Buenos-Ayres :	Buenos Aires, Argentina
En Buenos-Ayres: :	Buenos Aires, Argentina
In Civitate Bonaerensi :	Buenos Aires, Argentina
In Civitate Bonaerensi: :	Buenos Aires, Argentina
Reimpresa en Buenos-Ayres, :	Buenos Aires, Argentina
Reimpreso en Buenos-Ayres :	Buenos Aires, Argentina
Reimpreso en Buenos-Ayres. :	Buenos Aires, Argentina
[Buffalo, N.Y.,	Buffalo, New York
[Burlington, N.J. :	Burlington, New Jersey
[Burlington, N.J.]	Burlington, New Jersey
[Burlington, N.J.] :	Burlington, New Jersey
[Burlington? :	Burlington, New Jersey
Burlington, [N.J.] :	Burlington, New Jersey
Burlington, New-Jersey :	Burlington, New Jersey
Burlington :	Burlington, New Jersey
Burlington (N.J.), :	Burlington, New Jersey
Burlington [N.J.], :	Burlington, New Jersey
Burlington [N.J.]:	Burlington, New Jersey
Burlington [N.J.] :	Burlington, New Jersey
[Burlington, Vt. :	Burlington, Vermont
[Cambridge, Mass :	Cambridge, Massachusetts
[Cambridge, Mass.	Cambridge, Massachusetts
[Cambridge, Mass. :	Cambridge, Massachusetts
[Cambridge, Mass.? :	Cambridge, Massachusetts
[Cambridge, Mass.]	Cambridge, Massachusetts
[Cambridge, Mass.] :	Cambridge, Massachusetts
[Cambridge [Mass.] :	Cambridge, Massachusetts
Cambr [i.e., Cambridge, Mass.]: :	Cambridge, Massachusetts
Cambridg, [Mass.] :	Cambridge, Massachusetts
Cambridg [i.e., Cambridge, Mass.] :	Cambridge, Massachusetts
Cambridg [i.e., Cambridge, Mass.]. :	Cambridge, Massachusetts
Cambridge,	Cambridge, Massachusetts
Cambridge, (Mass.) :	Cambridge, Massachusetts
Cambridge, [Mass.]	Cambridge, Massachusetts
Cambridge, [Mass.] :	Cambridge, Massachusetts
Cambridge, Mass.	Cambridge, Massachusetts
Cambridge, Mass. :	Cambridge, Massachusetts
Cambridge :	Cambridge, Massachusetts
Cambridge: [Mass.]	Cambridge, Massachusetts
Cambridge [Mass. :	Cambridge, Massachusetts
Cambridge [Mass.],	Cambridge, Massachusetts
Cambridge [Mass.], :	Cambridge, Massachusetts
Cambridge [Mass.]:	Cambridge, Massachusetts
Cambridge [Mass.] :	Cambridge, Massachusetts
Cambridge [Mass.]: :	Cambridge, Massachusetts
Cambridge [Mass.]. :	Cambridge, Massachusetts
Cambridge [Mass.] printed :	Cambridge, Massachusetts
Massachvset :	Cambridge, Massachusetts
[Cap-Franais, i.e. Cap-Hatien, Haiti :	Cap-Haïtien, Haiti
[Cap-Franais, i.e. Cap-Hatien, Haiti? :	Cap-Haïtien, Haiti
[Cap-Franais, i.e. Cap-Hatien, Haiti] :	Cap-Haïtien, Haiti
[Cap-Franais, i.e. Cap-Hatien :	Cap-Haïtien, Haiti
[Cap-Franais, i.e. Cap-Hatien?] :	Cap-Haïtien, Haiti
[Cap-Franais? i.e. Cap-Hatien, Haiti] :	Cap-Haïtien, Haiti
[Cap-H¬¡aitien, Haiti?] :	Cap-Haïtien, Haiti
[Cap Hatien, Haiti? :	Cap-Haïtien, Haiti
[Cap-Hatien, Haiti? :	Cap-Haïtien, Haiti
[Cap Hatien, Haiti?] :	Cap-Haïtien, Haiti
[Cap-Hatien, Haiti?] :	Cap-Haïtien, Haiti
[Cap-Hatien, Haiti] :	Cap-Haïtien, Haiti
[Cap Hatien? :	Cap-Haïtien, Haiti
[Cap-Hatien? :	Cap-Haïtien, Haiti
[Cap Hatien?] :	Cap-Haïtien, Haiti
[Cap-Hatien] :	Cap-Haïtien, Haiti
Au Cap, Isle Saint-Domingue :	Cap-Haïtien, Haiti
Au Cap :	Cap-Haïtien, Haiti
Au Cap [Cap-Franais, i.e. Cap-Hatien, Haiti] :	Cap-Haïtien, Haiti
Au Cap [Cap-Hatien, Haiti] :	Cap-Haïtien, Haiti
Au Cap [i.e. Cap-Franais, Haiti] :	Cap-Haïtien, Haiti
Au Cap [i.e. Cap Hatien, Haiti] :	Cap-Haïtien, Haiti
Au Cap [i.e. Cap-Hatien, Haiti] :	Cap-Haïtien, Haiti
Au Cap [i.e. Cap-Hatien] :	Cap-Haïtien, Haiti
Au Cap-Franais :	Cap-Haïtien, Haiti
Au Cap-Franais [Cap-Hatien, Haiti] :	Cap-Haïtien, Haiti
Au Cap-Franais [i.e. Cap-Hatien, Haiti] :	Cap-Haïtien, Haiti
Au Cap-Franais [i.e. Cap-Hatien] :	Cap-Haïtien, Haiti
Au Cap-Francais [i.e. Cap Haiten] :	Cap-Haïtien, Haiti
Au Cap Franois :	Cap-Haïtien, Haiti
Au Cap-Franois :	Cap-Haïtien, Haiti
Au Cap-Franois [i.e. Cap-Hatien, Haiti] :	Cap-Haïtien, Haiti
Au Cap Franois [i.e. Cap Hatien] :	Cap-Haïtien, Haiti
Cap,	Cap-Haïtien, Haiti
[Carlisle, Pa.] :	Carlisle, Pennsylvania
Carlisle,	Carlisle, Pennsylvania
Carlisle, (Pennsylvania) :	Carlisle, Pennsylvania
Carlisle [Pa.], :	Carlisle, Pennsylvania
Carlisle [Pa.] :	Carlisle, Pennsylvania
Printed at Carlisle [Pa.] :	Carlisle, Pennsylvania
En Cartagena de Indias: :	Cartagena, Colombia
[Castine, Me.] :	Castine, Maine
Castine [Me.]: :	Castine, Maine
A Castries, isle Ste-Lucie :	Castries, Saint Lucia
[Catskill] :	Catskill, New York
Catskill, :	Catskill, New York
Catskill [N.Y.] :	Catskill, New York
Printed in Catskill [N.Y.] :	Catskill, New York
A Cayenne, :	Cayenne, French Guiana
A Cayenne [French Guiana], :	Cayenne, French Guiana
Chambersburg, Pa.,	Chambersburg, Pennsylvania
Chambersburg [Pa.] :	Chambersburg, Pennsylvania
Chambersburg [Pa.]: :	Chambersburg, Pennsylvania
[Charleston, S.C. :	Charleston, South Carolina
[Charleston, S.C.? :	Charleston, South Carolina
[Charleston, S.C.] :	Charleston, South Carolina
[Charleston, SC] :	Charleston, South Carolina
[Charleston. S.C. :	Charleston, South Carolina
[South Carolina? :	Charleston, South Carolina
A Charleston :	Charleston, South Carolina
Charleston,	Charleston, South Carolina
Charleston, S.C.,	Charleston, South Carolina
Charleston, S.C. :	Charleston, South Carolina
Charleston, South-Carolina :	Charleston, South Carolina
Charleston :	Charleston, South Carolina
Charleston: South-Carolina :	Charleston, South Carolina
Charleston (S.C.) :	Charleston, South Carolina
Charleston [S.C.]	Charleston, South Carolina
Charleston [S.C.] :	Charleston, South Carolina
Charleston [S.C.]: :	Charleston, South Carolina
Charlestown,	Charleston, South Carolina
Charles-Town, South-Carolina: :	Charleston, South Carolina
Charlestown: :	Charleston, South Carolina
Charles-Town [i.e., Charleston, S.C.] :	Charleston, South Carolina
Charles-Town [i.e. Charleston, S.C.] :	Charleston, South Carolina
Charlestown [S.C.] :	Charleston, South Carolina
Charles-Town [S.C.] :	Charleston, South Carolina
South-Carolina, Charles-Town :	Charleston, South Carolina
South Carolina: Charles-Town :	Charleston, South Carolina
South-Carolina: Charles-Town :	Charleston, South Carolina
[Charlestown, Mass. :	Charlestown, Massachusetts
[Charlestown, Mass.] :	Charlestown, Massachusetts
[Charlestown? :	Charlestown, Massachusetts
Caroloppidi [Mass.]	Charlestown, Massachusetts
Charlestown:	Charlestown, Massachusetts
Charlestown: (Massachusetts.) :	Charlestown, Massachusetts
Charlestown [Mass.]	Charlestown, Massachusetts
Charlestown [Mass.] :	Charlestown, Massachusetts
Charlestown [Mass.]: :	Charlestown, Massachusetts
Charlestown  Mass.  :	Charlestown, Massachusetts
Massachusetts: Printed at Charlestown :	Charlestown, Massachusetts
Charlottesville [Va.] :	Charlottesville, Virginia
Chatham: [N.J.] :	Chatham, New Jersey
Chatham [N.J.] :	Chatham, New Jersey
[Chelmsford, Mass.? :	Chelmsford, Massachusetts
Chelmsford, Mass. :	Chelmsford, Massachusetts
[Cheshire, Conn.,	Cheshire, Connecticut
[Cheshire, Conn. :	Cheshire, Connecticut
[Cheshire, Conn.?	Cheshire, Connecticut
[Cheshire, Conn.? :	Cheshire, Connecticut
Cheshire, Conn.,	Cheshire, Connecticut
Cheshire, Conn.]	Cheshire, Connecticut
Cheshire: Connecticut. :	Cheshire, Connecticut
Cheshire [Conn.] :	Cheshire, Connecticut
Chesire: Connecticut. :	Cheshire, Connecticut
Ches[t]nuthill [Pa.] :	Chestnut Hill, Pennsylvania
Chesnuthill (Pa.) :	Chestnut Hill, Pennsylvania
Chesnut-Hill (Pa.) :	Chestnut Hill, Pennsylvania
Chesnuthill [Pa.], :	Chestnut Hill, Pennsylvania
Chesnuthill [Pa.] :	Chestnut Hill, Pennsylvania
Chestnuthill [Pa.] :	Chestnut Hill, Pennsylvania
[Cincinnati, Ohio :	Cincinnati, Ohio
Cincinnati,	Cincinnati, Ohio
Cincinnati :	Cincinnati, Ohio
Cincinnati [Ohio] :	Cincinnati, Ohio
Concord [Mass.] :	Concord, Massachusetts
[Concord, N.H.,	Concord, New Hampshire
[Concord, N.H.] :	Concord, New Hampshire
[Concord] :	Concord, New Hampshire
Concord,	Concord, New Hampshire
Concord, N.H. :	Concord, New Hampshire
Concord, N.H.?	Concord, New Hampshire
Concord [N.H.] :	Concord, New Hampshire
Concord [N.H.]: :	Concord, New Hampshire
Printed at Concord [N.H.], :	Concord, New Hampshire
Printed at Concord [N.H], :	Concord, New Hampshire
Conway [Mass.]: :	Conway, Massachusetts
Cooperstown [N.Y.] :	Cooperstown, New York
[Danbury, Conn. :	Danbury, Connecticut
[Danbury, Conn.] :	Danbury, Connecticut
[Danbury} :	Danbury, Connecticut
Danbury,	Danbury, Connecticut
Danbury :	Danbury, Connecticut
Danbury [Conn.] :	Danbury, Connecticut
Printed in Danbury [Conn.], :	Danbury, Connecticut
Danvers [Mass.] :	Danvers, Massachusetts
[Dedham, Mass.] :	Dedham, Massachusetts
Dedham,	Dedham, Massachusetts
Dedham :	Dedham, Massachusetts
Dedham [Mass.]	Dedham, Massachusetts
Dedham [Mass.] :	Dedham, Massachusetts
Dedham [Mass.]: :	Dedham, Massachusetts
Printed at Dedham [Mass.], :	Dedham, Massachusetts
Dexter, Me.,	Dexter, Maine
[Dorchester, Mass.,	Dorchester, Massachusetts
[Dover, N.H.] :	Dover, New Hampshire
[Dover?] New-Hampshire :	Dover, New Hampshire
Dover, (N.H.) :	Dover, New Hampshire
Dover, (New-Hampshire:) :	Dover, New Hampshire
Dover, (New-Hampshire.) :	Dover, New Hampshire
Dover, N.H.,	Dover, New Hampshire
Dover, N.H. :	Dover, New Hampshire
Dover :	Dover, New Hampshire
Dover [N.H.], :	Dover, New Hampshire
Dover [N.H.] :	Dover, New Hampshire
Dover [N.H.]: :	Dover, New Hampshire
Printed at Dover, (N.H.) :	Dover, New Hampshire
Printed at Dover, New-Hampshire :	Dover, New Hampshire
Printed at Dover [N.H.]	Dover, New Hampshire
Printed at Dover [N.H.], :	Dover, New Hampshire
Printed at Dover [N.H.] :	Dover, New Hampshire
[Dumfries, Va. :	Dumfries, Virginia
[Easthampton, Massachusetts?	Easthampton, Massachusetts
[Easton, Md.? :	Easton, Maryland
Easton [Md.]: :	Easton, Maryland
[East Windsor, Conn.,	East Windsor, Connecticut
Printed at East-Windsor [Conn.], :	East Windsor, Connecticut
[Edenton, N.C. :	Edenton, North Carolina
[Edenton, N.C.? :	Edenton, North Carolina
Edenton [N.C.] :	Edenton, North Carolina
[Elizabeth, N.J. :	Elizabeth, New Jersey
[Elizabethtown, N.J.] :	Elizabethtown, New Jersey
Elizabeth-town,	Elizabethtown, New Jersey
Elizabeth-Town, (New-Jersey) :	Elizabethtown, New Jersey
Elizabeth-Town, [N.J.]: :	Elizabethtown, New Jersey
Elizabethtown :	Elizabethtown, New Jersey
Elizabeth Town: :	Elizabethtown, New Jersey
Elizabethtown [Elizabeth, N.J.] :	Elizabethtown, New Jersey
Elizabeth Town [Elizabeth, N.J.] :	Elizabethtown, New Jersey
Elizabethtown [N.J.] :	Elizabethtown, New Jersey
Elizabeth Town [N.J.] :	Elizabethtown, New Jersey
Elizabeth-town [N.J.] :	Elizabethtown, New Jersey
Elizabeth-Town [N.J.] :	Elizabethtown, New Jersey
Elizabeth-Town [N.J.]: :	Elizabethtown, New Jersey
[Ephrata, Pa. :	Ephrata, Pennsylvania
[Ephrata, Pa.? :	Ephrata, Pennsylvania
[Ephrata :	Ephrata, Pennsylvania
[Ephrata?] :	Ephrata, Pennsylvania
[Ephrata] :	Ephrata, Pennsylvania
Efrata, im Jahr des Heils, 1745. :	Ephrata, Pennsylvania
Ephrat¾ :	Ephrata, Pennsylvania
Ephrat¾ [Pa.] :	Ephrata, Pennsylvania
Ephrata, :	Ephrata, Pennsylvania
Ephrata, in Peusylvanien [sic], :	Ephrata, Pennsylvania
Ephrata, Pa. :	Ephrata, Pennsylvania
Ephrata :	Ephrata, Pennsylvania
Ephrata. :	Ephrata, Pennsylvania
Ephrata [Pa.], :	Ephrata, Pennsylvania
Ephrata [Pa.] :	Ephrata, Pennsylvania
Ephrata [Pa.]: :	Ephrata, Pennsylvania
Ephrata in Pennsylvania. :	Ephrata, Pennsylvania
Ephrata in Pennsylvanien. :	Ephrata, Pennsylvania
Ephrata in Pensylvanien :	Ephrata, Pennsylvania
[Exeter, N.H. :	Exeter, New Hampshire
[Exeter, N.H.?	Exeter, New Hampshire
[Exeter, N.H.? :	Exeter, New Hampshire
[Exeter, N.H.] :	Exeter, New Hampshire
[Exeter] :	Exeter, New Hampshire
[Exeter] New-Hampshire :	Exeter, New Hampshire
[Exeter] State of New-Hampshire: :	Exeter, New Hampshire
Exeter, [N.H.]	Exeter, New Hampshire
Exeter, [N.H.] :	Exeter, New Hampshire
Exeter, N.H.,	Exeter, New Hampshire
Exeter, New-Hampshire :	Exeter, New Hampshire
Exeter [N. H.]	Exeter, New Hampshire
Exeter [N.H.] :	Exeter, New Hampshire
Exeter [N.H.]: :	Exeter, New Hampshire
New-Hampshire,	Exeter, New Hampshire
New-Hampshire :	Exeter, New Hampshire
New-Hampshire: Exeter, :	Exeter, New Hampshire
Printed at Exeter, [N.H.] :	Exeter, New Hampshire
Printed at Exeter, Newhampshire,	Exeter, New Hampshire
Printed at Exeter, NewHampshire, :	Exeter, New Hampshire
Printed at Exeter, Newhampshire :	Exeter, New Hampshire
Printed at Exeter, New-Hampshire :	Exeter, New Hampshire
Printed at Exeter [N.H.], :	Exeter, New Hampshire
Printed at Exeter [N.H.] :	Exeter, New Hampshire
Printed at Exeter [N.H.]: :	Exeter, New Hampshire
Fairfield [Conn.] :	Fairfield, Connecticut
Fairfield [Conn] :	Fairfield, Connecticut
[Fairhaven, Vt.] :	Fair Haven, Vermont
Fairhaven [Vt.] :	Fair Haven, Vermont
Farmington, Conn.]	Farmington, Connecticut
[Fishkill, N.Y. :	Fishkill, New York
Fish-kill [N.Y.] :	Fishkill, New York
Fish-Kill [N.Y.] :	Fishkill, New York
[Fort-de-France, Martinique :	Fort-de-France, Martinique
[Frankfort, Ky. :	Frankfort, Kentucky
Frankfort [Ky.] :	Frankfort, Kentucky
Frederick Town [Md.]	Frederick, Maryland
Frederick-Town [Md.] :	Frederick, Maryland
Friederich-Stadt [i.e. Frederick, Md.] :	Frederick, Maryland
Friederich-Stadt [Md.] :	Frederick, Maryland
[Fredericktown, Md.? :	Fredericktown, Maryland
[Fredericktown, Md.] :	Fredericktown, Maryland
Printed at Fryeburg [Me.] :	Fryeburg, Maine
Gainsborough,	Gainsborough, Tennessee
Printed at Geneva, New-York, :	Geneva, New York
[Germanton] :	Germantown, Pennsylvania
[Germantown, Pa.] :	Germantown, Pennsylvania
[Germantown, Penn. :	Germantown, Pennsylvania
Germantaun,	Germantown, Pennsylvania
Germantaun, :	Germantown, Pennsylvania
Germantaun:	Germantown, Pennsylvania
Germantaun :	Germantown, Pennsylvania
Germantaun. :	Germantown, Pennsylvania
Germantaun (Pa.)	Germantown, Pennsylvania
Germantaun [Germantown, Pa.] :	Germantown, Pennsylvania
Germantaun [Pa.]	Germantown, Pennsylvania
Germantaun [Pa.],	Germantown, Pennsylvania
Germantaun [Pa.] :	Germantown, Pennsylvania
Germantaun [Pa.]: :	Germantown, Pennsylvania
Germanton,	Germantown, Pennsylvania
Germanton, :	Germantown, Pennsylvania
Germanton :	Germantown, Pennsylvania
Germanton [Pa.] :	Germantown, Pennsylvania
Germanton [Philadelphia]	Germantown, Pennsylvania
Germantown,	Germantown, Pennsylvania
Germantown, :	Germantown, Pennsylvania
Germantown, (Pa) :	Germantown, Pennsylvania
Germantown:	Germantown, Pennsylvania
Germantown :	Germantown, Pennsylvania
Germantown: :	Germantown, Pennsylvania
Germantown [Pa.], :	Germantown, Pennsylvania
Germantown [Pa.] :	Germantown, Pennsylvania
Germantown [Pa.]: :	Germantown, Pennsylvania
Germantown [Penn.] :	Germantown, Pennsylvania
Germantown [Penn.]: :	Germantown, Pennsylvania
Solingen, dass erstemal herausgegeben, und nun in Germantaun, :	Germantown, Pennsylvania
Printed at Gilmanton [N.H.], :	Gilmanton, New Hampshire
Goshen [N. Y.]	Goshen, New York
Goshen [N.Y.] :	Goshen, New York
Goshen [N.Y.]: :	Goshen, New York
[Granville, Mass.? :	Granville, Massachusetts
[Greenfield] :	Greenfield, Massachusetts
Greenfield, (Mass.) :	Greenfield, Massachusetts
Greenfield, (Massachusetts:)	Greenfield, Massachusetts
Greenfield, (Massachusetts:) :	Greenfield, Massachusetts
Greenfield, Massachusetts,	Greenfield, Massachusetts
Greenfield [Mass.]: :	Greenfield, Massachusetts
Printed at Greenfield, (Massachusetts) :	Greenfield, Massachusetts
Printed at Greenfield, Massachusetts, :	Greenfield, Massachusetts
Printed at Greenfield, Massachusetts :	Greenfield, Massachusetts
Printed at Greenfield, Massachusetts. :	Greenfield, Massachusetts
Printed at Greenfield [Mass.], :	Greenfield, Massachusetts
[Guadalajara? :	Guadalajara, Mexico
[Guadalajara?] :	Guadalajara, Mexico
Guadalaxara :	Guadalajara, Mexico
Impreso en Guadalaxara, :	Guadalajara, Mexico
Reimpresa en Guadalaxara, :	Guadalajara, Mexico
Reimpreso en Guadalaxara :	Guadalajara, Mexico
A la Guadeloupe :	Guadeloupe, Guadeloupe
[Guatemala City :	Guatemala City, Guatemala
[Halifax, N.C.? :	Halifax, North Carolina
Halifax [N.C.] :	Halifax, North Carolina
[Halifax, N.S. :	Halifax, Nova Scotia
[Halifax, N.S.? :	Halifax, Nova Scotia
Halifax	Halifax, Nova Scotia
Halifax, :	Halifax, Nova Scotia
Halifax, in Nova Scotia :	Halifax, Nova Scotia
Halifax :	Halifax, Nova Scotia
Halifax [N.S.] :	Halifax, Nova Scotia
Halifax [N.S.]: :	Halifax, Nova Scotia
[Hallowell, Me.] :	Hallowell, Maine
Hallowell, (District of Maine,) :	Hallowell, Maine
Hallowell, (District of Maine) :	Hallowell, Maine
Hallowell (District of Maine) :	Hallowell, Maine
Hallowell (Maine)	Hallowell, Maine
Hallowell [Me.] :	Hallowell, Maine
Printed at Hallowell, Hook, [Me.] :	Hallowell, Maine
Printed at Hallowell, Hook [Me.], :	Hallowell, Maine
Printed at the Hook, Hallowell [Me.], :	Hallowell, Maine
Printed at the Hook, Hallowell [Me.] :	Hallowell, Maine
[Dresden, Vt., i.e., Hanover, N.H. :	Hanover, New Hampshire
[Dresden, Vt., i.e., Hanover, N.H.] :	Hanover, New Hampshire
[Dresden, Vt.  i.e., Hanover, N.H. :	Hanover, New Hampshire
[Hanover, N.H.? :	Hanover, New Hampshire
[Hanover, N.H.] :	Hanover, New Hampshire
[Hanover] :	Hanover, New Hampshire
Dresden, State of Vermont [i.e., Hanover, N.H.]: :	Hanover, New Hampshire
Dresden [Vt.] :	Hanover, New Hampshire
Hanover, (N.H.) :	Hanover, New Hampshire
Hanover, New-Hampshire, :	Hanover, New Hampshire
Hanover [N.H.] :	Hanover, New Hampshire
Printed, at Hanover, New-Hampshire :	Hanover, New Hampshire
Printed at Hanover, Newhampshire :	Hanover, New Hampshire
Printed at Hanover [N.H.], :	Hanover, New Hampshire
Printed at Hanover [N.H.] :	Hanover, New Hampshire
Hannover :	Hanover, Pennsylvania
Hanover (M'Alister's Stadt) [Pa.]: :	Hanover, Pennsylvania
[Harrisburg, Pa. :	Harrisburg, Pennsylvania
[Harrisburgh] :	Harrisburg, Pennsylvania
Printed at Harrisburgh [Pa.] :	Harrisburg, Pennsylvania
[Hartford,	Hartford, Connecticut
[Hartford, Conn.,	Hartford, Connecticut
[Hartford, Conn. :	Hartford, Connecticut
[Hartford, Conn.] :	Hartford, Connecticut
[Hartford, Ct.] :	Hartford, Connecticut
[Hartford :	Hartford, Connecticut
[Hartford? :	Hartford, Connecticut
[Hartford?] :	Hartford, Connecticut
[Hartford] :	Hartford, Connecticut
Hartford--	Hartford, Connecticut
Hartford,	Hartford, Connecticut
"Hartford,;""London,"""	Hartford, Connecticut
Hartford, :	Hartford, Connecticut
Hartford, (Connecticut) :	Hartford, Connecticut
Hartford, [Conn.]	Hartford, Connecticut
Hartford, [etc. :	Hartford, Connecticut
Hartford, Conn.	Hartford, Connecticut
Hartford:	Hartford, Connecticut
Hartford :	Hartford, Connecticut
Hartford  :	Hartford, Connecticut
Hartford: :	Hartford, Connecticut
Hartford: [Conn.] :	Hartford, Connecticut
Hartford [Conn.]:	Hartford, Connecticut
Hartford [Conn.] :	Hartford, Connecticut
Hartfordiae :	Hartford, Connecticut
Hartord :	Hartford, Connecticut
Printed at Hartford, :	Hartford, Connecticut
[Habana :	Havana, Cuba
[Havana :	Havana, Cuba
[Havana? :	Havana, Cuba
[Havana] :	Havana, Cuba
En la Havana :	Havana, Cuba
Havana :	Havana, Cuba
Havana: :	Havana, Cuba
Havana MDCCXCVI :	Havana, Cuba
Impresso en la Havana :	Havana, Cuba
Reimpresa en la Habana :	Havana, Cuba
Reimpreso en la Habana :	Havana, Cuba
[Haverhill, Mass.] :	Haverhill, Massachusetts
Haverhill, (Massachusetts) :	Haverhill, Massachusetts
Haverhill [Mass.], :	Haverhill, Massachusetts
Haverhill [Mass.] :	Haverhill, Massachusetts
Haverhill [Mass.]. :	Haverhill, Massachusetts
Printed at Haverhill, Massachusetts :	Haverhill, Massachusetts
[Haverhill, N.H.? :	Haverhill, New Hampshire
Haverhill, New-Hampshire, :	Haverhill, New Hampshire
Haverhill (N.H.) :	Haverhill, New Hampshire
Hopkinton [Mass.] :	Hopkinton, Massachusetts
Hudson :	Hudson, New Jersey
[Hudson, N.Y.] :	Hudson, New York
Hudson [N.Y.] :	Hudson, New York
Hudson [N.Y.]: :	Hudson, New York
Hull,	Hull, Massachusetts
Jamaica 	Jamaica, Jamaica
Jamaica :	Jamaica, Jamaica
[Keene, N.H.? :	Keene, New Hampshire
[Keene, N.H.]: :	Keene, New Hampshire
Keene, (State of New-Hampshire) :	Keene, New Hampshire
Keene-(Newhampshire:)	Keene, New Hampshire
Keene--(Newhampshire:) :	Keene, New Hampshire
Keene--(NewHampshire:) :	Keene, New Hampshire
Keene--(Newhampshire ) :	Keene, New Hampshire
Keene--Newhampshire :	Keene, New Hampshire
Printed at Keene--(New Hampshire,) :	Keene, New Hampshire
[Kingston,] Jamaica :	Kingston, Jamaica
Kingston, Ja.,	Kingston, Jamaica
Kingston, Jamaica:	Kingston, Jamaica
Kingston, Jamaica :	Kingston, Jamaica
Kingston :	Kingston, Jamaica
Kingston [Jamaica] :	Kingston, Jamaica
[Kingstown [Saint Vincent],	Kingstown, St. Vincent & The Grenadine
[Kingstown [Saint Vincent]?,	Kingstown, St. Vincent & The Grenadine
[Kingstown] :	Kingstown, St. Vincent & The Grenadine
[Knoxville, Tenn. :	Knoxville, Tennessee
Knoxville [Tenn.] :	Knoxville, Tennessee
[Lancaster, Pa.,	Lancaster, Pennsylvania
[Lancaster, Pa. :	Lancaster, Pennsylvania
[Lancaster, Pa.? :	Lancaster, Pennsylvania
[Lancaster, Pa.] :	Lancaster, Pennsylvania
[Lancaster] :	Lancaster, Pennsylvania
"Germantown :;""in Philadelphia, :"";""in Lancster, :"";""in Neuyork, :"""	Lancaster, Pennsylvania
"Germantown :;""in Philadelphia :"";""in Lancester :"""	Lancaster, Pennsylvania
"Germantown :;""in Philadelphia :"";""in Lancester :"";""in Neuyorck :"""	Lancaster, Pennsylvania
"Germantown :;""in Philadelphia :"";""in Lancster :"";""in Neuyorck :"""	Lancaster, Pennsylvania
Lancaster [Pa.], :	Lancaster, Pennsylvania
Lancaster [Pa.] :	Lancaster, Pennsylvania
Lancster [Pa.] :	Lancaster, Pennsylvania
Lancster [Pa.]: :	Lancaster, Pennsylvania
[Lansingburgh, N.Y.] :	Lansingburgh, New York
Lansingburgh [N.Y.] :	Lansingburgh, New York
Lansingburgh [N.Y.]: :	Lansingburgh, New York
[Leominster, Ma.?	Leominster, Massachusetts
[Leominster, Mass.]	Leominster, Massachusetts
[Leominster, Mass.] :	Leominster, Massachusetts
Leominister, Massachusetts,	Leominster, Massachusetts
Leominister, Massachusetts :	Leominster, Massachusetts
Leominister [Mass.] :	Leominster, Massachusetts
Leominster, (Mass.) :	Leominster, Massachusetts
Leominster, (Massachusetts) :	Leominster, Massachusetts
Leominster, <Massachusetts>	Leominster, Massachusetts
Leominster, Mass.,	Leominster, Massachusetts
Leominster, Mass. :	Leominster, Massachusetts
Leominster, Massachusetts, :	Leominster, Massachusetts
Leominster, Massachusetts: :	Leominster, Massachusetts
Leominster (Mass.)	Leominster, Massachusetts
Leominster [Mass.]	Leominster, Massachusetts
Leominster [Mass.] :	Leominster, Massachusetts
Printed at Leominster, (Mass.)	Leominster, Massachusetts
Printed at Leominster, (Massachusetts) :	Leominster, Massachusetts
[Les Cayes? :	Les Cayes, Haiti
Aux Cayes :	Les Cayes, Haiti
Aux Cayes [Haiti] :	Les Cayes, Haiti
[Lexington, Ky. :	Lexington, Kentucky
Lexington [Ky.] :	Lexington, Kentucky
Lexington  printed--Philadelphia: reprinted,	Lexington, Kentucky
[Con licencia en Lima :	Lima, Peru
[Cuzco? :	Lima, Peru
[Juli, Peru] :	Lima, Peru
[Lima :	Lima, Peru
[Lima :s.n., 163-?]	Lima, Peru
[Lima : s.n.],	Lima, Peru
[Lima? :	Lima, Peru
[Lima] :	Lima, Peru
[Lima] : Lo Imprimi Francisco Gomez, Pastrana, en la calle de San Agustin.,	Lima, Peru
Ao 1621. Con licencia en Lima :	Lima, Peru
Ao 1759. Con licencia en Lima :	Lima, Peru
Con licencia, en Lima :	Lima, Peru
Con licencia, impresso en Lima, :	Lima, Peru
Con licencia, impresso en Lima :	Lima, Peru
Con licencia, reimpresso en Lima :	Lima, Peru
Con licencia: en Lima :	Lima, Peru
Con licencia. En Lima :	Lima, Peru
Con licencia. Impresa en Lima :	Lima, Peru
Con licencia. Impresso en Lima :	Lima, Peru
Con licencia del ordinario: en Lima :	Lima, Peru
Con licencia del ordinario: impressa en Lima :	Lima, Peru
Con licencia del ordinario: Reimpresa en Lima :	Lima, Peru
Con licencia del ordinario. Impresso en Lima :	Lima, Peru
Con licencia de los superiores, en Lima :	Lima, Peru
Con licencia de los superiores, impresso en Lima :	Lima, Peru
Con licencia de los superiores. En Lima :	Lima, Peru
Con licencia de los superiores de Lima :	Lima, Peru
Con licencia de los superiores en Lima :	Lima, Peru
Con licencia em [sic] Lima, :	Lima, Peru
Con licencia en Lima :	Lima, Peru
Con Licencia en Lima :	Lima, Peru
Con licencia en Lima  :	Lima, Peru
Con licencia en Lima. :	Lima, Peru
Con licencia en Lima. : En la Imprenta nueva de la Calle de Iesus Maria., [1718]	Lima, Peru
Con licencia impreso en Lima :	Lima, Peru
Con licencia impresso en Lima :	Lima, Peru
Con licencia reimpresa en Lima :	Lima, Peru
Con licensia se imprimio en Madrid, ao de 1628.  Y en Lima :	Lima, Peru
Con superior permiso. En Lima :	Lima, Peru
En Gijon [i.e. Lima, Peru] :	Lima, Peru
En Gijon [i.e. Lima] :	Lima, Peru
En Lima, :	Lima, Peru
En Lima, con las licencias necessarias :	Lima, Peru
En Lima :	Lima, Peru
En Lima  :	Lima, Peru
En Lima: :	Lima, Peru
En Lima: con licencia de los superiores: :	Lima, Peru
En Lima : En la Calle del Tygre., ao de 1757.	Lima, Peru
En Lima. :	Lima, Peru
En Lima con licencia del Real Govierno :	Lima, Peru
En Lima con licencia de su excelencia, :	Lima, Peru
En Lima en la Calle del Tigre :	Lima, Peru
En Lima en la Calle de S. Ildephonso :	Lima, Peru
En los Reyes. :	Lima, Peru
En Los Reyes [i.e. Lima] :	Lima, Peru
En Los Reyes [Lima]. :	Lima, Peru
Impresa en Lima, :	Lima, Peru
Impresa en Lima :	Lima, Peru
Impresa en Lima: :	Lima, Peru
Impresa en Lima: con los debidos permisos :	Lima, Peru
Impresa en Lima. :	Lima, Peru
Impresa en Lima con las licencias necesarias :	Lima, Peru
Impresas en Lima: :	Lima, Peru
Impresas en Madrid, de orden del Rey nuestro seor. Y reimpresas en Lima con licencia del Superior Gobierno :	Lima, Peru
Impreso en Lima, :	Lima, Peru
Impreso en Lima, con licencia de su Ex[ce]lencia, :	Lima, Peru
Impreso en Lima :	Lima, Peru
Impreso  en Lima: con las licencias necesarias :	Lima, Peru
Impreso en Lima con las debidas licencias :	Lima, Peru
Impresos en Lima :	Lima, Peru
Impressa ... en esta dicha Ciudad delos Reyes [Lima] ... :	Lima, Peru
Impressa enla Ciudad de los Reyes [Lima] del Peru :	Lima, Peru
Impressa en Lima, :	Lima, Peru
Impressa en Lima, Calle de la Barranca :	Lima, Peru
Impressa en Lima, con las lice[n]cias necessarias, :	Lima, Peru
Impressa en Lima, con licencia del Superior Govierno, :	Lima, Peru
Impressa en Lima :	Lima, Peru
Impressa en Lima  :	Lima, Peru
Impressas en Lima, por mandado de su excelencia. :	Lima, Peru
Impresso ... en la Ciudad delos Reyes, :	Lima, Peru
Impresso ... en la Ciudad de los Reyes, :	Lima, Peru
Impresso con las debidas licencias en Lima :	Lima, Peru
Impresso con licencas en Lima :	Lima, Peru
Impresso con licencia del seor virrey, en Lima  :	Lima, Peru
Impresso en ... Iuli [Peru] ... :	Lima, Peru
Impresso en Cumas [i.e. Lima] : en la oficina de la Sybila, con otras obrillas mas que despues saldran,	Lima, Peru
Impresso en la casa de la Compaia de Iesus de Iuli pueblo en la Prouincia de Chucuito [Peru]. :	Lima, Peru
Impresso en la Ciudad de los Reyes, ... :	Lima, Peru
Impresso enla Ciudad de los Reyes :	Lima, Peru
Impresso en la Ciudad delos Reyes [Lima], :	Lima, Peru
Impresso en la Ciudad de los Reyes [Lima] :	Lima, Peru
Impresso en la ciudad de los Reyes [Lima]  :	Lima, Peru
Impresso en Lima, :	Lima, Peru
Impresso en Lima, ... :	Lima, Peru
Impresso en Lima, por mandado de su excelencia :	Lima, Peru
Impresso en Lima :	Lima, Peru
Impresso en Lima  :	Lima, Peru
"Impresso en Lima  :;""o de 1625."""	Lima, Peru
Impresso en Lima: :	Lima, Peru
Impresso en Lima extramuros de Santa Cathalina :	Lima, Peru
Lim¾ :	Lima, Peru
Lima,	Lima, Peru
Lima :	Lima, Peru
Lima. :	Lima, Peru
Limae, :	Lima, Peru
Limae :	Lima, Peru
Limae. :	Lima, Peru
Reimpresa: en Lima :	Lima, Peru
Reimpresa [en Lima] :	Lima, Peru
Reimpresa en Lima :	Lima, Peru
Reimpreso en Lima, :	Lima, Peru
Reimpreso en Lima :	Lima, Peru
Reimpreso en Lima : En la Oficina de los Nios Hurfanos., [1774]	Lima, Peru
Reimpreso en Lima con las licencias necesarias :	Lima, Peru
Reimpreso en Lima  diligencia de los RR.PP. missioneros apostolicos de S. Francisco :	Lima, Peru
Reimpreso en Lma [sic] :	Lima, Peru
Reimpressa en Lima :	Lima, Peru
Reimpressas en Lima ... :	Lima, Peru
Reimpresso con licencias en Lima :	Lima, Peru
Reimpresso en Lima,	Lima, Peru
Reimpresso en Lima :	Lima, Peru
Reimresa [sic] en Lima :	Lima, Peru
[Litchfield, Conn.] :	Litchfield, Connecticut
Litchfield, (Connecticut) :	Litchfield, Connecticut
Litchfield, Conn.,	Litchfield, Connecticut
Litchfield [Conn.]:	Litchfield, Connecticut
Litchfield [Conn.] :	Litchfield, Connecticut
Litchfield [Conn.]: :	Litchfield, Connecticut
Litchfield [Conn]: :	Litchfield, Connecticut
Printed at Litchfield, :	Litchfield, Connecticut
Printed at Litchfield [Conn.], :	Litchfield, Connecticut
Printed at Litchfield [Conn.] :	Litchfield, Connecticut
Re-printed at Lichfield [sic] [Conn.] :	Litchfield, Connecticut
En Loreto [Paraguay], :	Loreto, Paraguay
Superiorum permissu Laureti [Loreto] :	Loreto, Paraguay
Lynn	Lynn, Massachusetts
Lynn,	Lynn, Massachusetts
Lynn Regis	Lynn, Massachusetts
Medford [Mass.]: :	Medford, Massachusetts
Printed at Medford, (Massachusetts. :	Medford, Massachusetts
Printed at Medford, (Massachusetts.) :	Medford, Massachusetts
... en Mexico :	Mexico City, Mexico
(Con licencia de los superiores, en Mexico:) :	Mexico City, Mexico
(D. L. D. R.) Mexici :	Mexico City, Mexico
[8], 330 leaves :	Mexico City, Mexico
[En] Mexico :	Mexico City, Mexico
[Mexico  	Mexico City, Mexico
[Mexico,	Mexico City, Mexico
[Mexico :	Mexico City, Mexico
[ Mexico :	Mexico City, Mexico
[Mexico? :	Mexico City, Mexico
[Mexico]	Mexico City, Mexico
[Mexico] :	Mexico City, Mexico
[Mexico] Impreso en Madrid ao de M.DCC.LXXXIV :	Mexico City, Mexico
[Mexico] Impressa en Madrid, y por su original ... reimpressa en Mexico :	Mexico City, Mexico
[Mexico City, Mexico :	Mexico City, Mexico
[Mexico City :	Mexico City, Mexico
[Mexico City?,	Mexico City, Mexico
[Mexico City? :	Mexico City, Mexico
[Mexico City] :	Mexico City, Mexico
[Mexico City] : M. DCC. LXXVII. Mexici: ex nova typ. matritensi apud D. Philippum de Zuiga & Ontiveros, in via Palmae,	Mexico City, Mexico
[Mxico,	Mexico City, Mexico
[Mxico :	Mexico City, Mexico
[Mxico :Imprenta de el Superior Gobierno, de el Br. D. Joseph Antonio de Hogal?,	Mexico City, Mexico
[Mxico] :	Mexico City, Mexico
[Mxico] :Hogal,	Mexico City, Mexico
[Tenuchtiltlan, Mexico,	Mexico City, Mexico
Ampliss. Rect. Facult. Mexici :	Mexico City, Mexico
Anno 1675. Mexici, :	Mexico City, Mexico
Con las licencias mecesarias: en Mexico :	Mexico City, Mexico
Con las licencias necasarias impreso en Mxico :	Mexico City, Mexico
Con las licencias necesarias. En Mexico :	Mexico City, Mexico
Con las licencias necesarias impreso en Mxico :	Mexico City, Mexico
Con las licencias necessarias, impresso en Mexico :	Mexico City, Mexico
Con las licencias necessarias: impresso, en Mexico :	Mexico City, Mexico
Con las licencias necessarias. Impresso en Mexico :	Mexico City, Mexico
Con las licencias necessarias impresso en Mexico :	Mexico City, Mexico
Con licenca: en Mexico :	Mexico City, Mexico
Con licencia, en Mexico, :	Mexico City, Mexico
Con licencia, en Mexico :	Mexico City, Mexico
Con licencia, y privilegio. En Mexico :	Mexico City, Mexico
Con licencia, y privilegio en Mexico :	Mexico City, Mexico
Con licencia: en Mexico :	Mexico City, Mexico
Con licencia: impresso en Mexico :	Mexico City, Mexico
Con licencia. En Mexico :	Mexico City, Mexico
Con licencia de el Excmo. seor vi-rey, en Mexico :	Mexico City, Mexico
Con licencia de el superior govierno. En Mexico :	Mexico City, Mexico
Con licencia de el superior govierno. En Mxico :	Mexico City, Mexico
Con licencia de los superiores, en Mexico :	Mexico City, Mexico
Con licencia de los superiores, impreso en Mxico :	Mexico City, Mexico
Con licencia de los superiores, impresso en Mexico :	Mexico City, Mexico
Con licencia de los superiores: en Mexico :	Mexico City, Mexico
Con licencia de los superiores: en Mxico :	Mexico City, Mexico
Con licencia de los superiores. En Mexico :	Mexico City, Mexico
Con licencia de los superiores. Impressa en Mexico :	Mexico City, Mexico
Con licencia de los superiores. Impresso en Mexico :	Mexico City, Mexico
Con licencia de los superiores en Mexico :	Mexico City, Mexico
Con licencia en Mexico, :	Mexico City, Mexico
Con licencia en Mexico :	Mexico City, Mexico
Con licencia en Mexico: :	Mexico City, Mexico
Con licencia en Mexico.:	Mexico City, Mexico
Con licencia en Mxico :	Mexico City, Mexico
Con todas las licencias de los superiores. En Mexico :	Mexico City, Mexico
Cum gratia, et pri[vi]legio Mexici :	Mexico City, Mexico
De orden de su Exc. Impresas en Mxico : Por D. Felipe de Ziga y Ontiveros, calle de la Palma., [1781]	Mexico City, Mexico
En dicha ciudad [de Mexico] :	Mexico City, Mexico
En Lima. Y por su original en Mexico, con las licencias necessarias :	Mexico City, Mexico
En Madrid, Por Juan Garcia Infanzon, ao de 1711. Y por su original reimpresso en Mexico, con licencia :	Mexico City, Mexico
En Megico :	Mexico City, Mexico
En Mexco :	Mexico City, Mexico
En Mexico,	Mexico City, Mexico
En Mexico,:	Mexico City, Mexico
En Mexico, :	Mexico City, Mexico
En Mexico, con licencia :	Mexico City, Mexico
En Mexico:	Mexico City, Mexico
En Mexico :	Mexico City, Mexico
En Mexico  :	Mexico City, Mexico
En Mexico: :	Mexico City, Mexico
En  Mexico: :	Mexico City, Mexico
En Mexico.:	Mexico City, Mexico
En Mexico. :	Mexico City, Mexico
En Mexico [con las licencias necessarias] :	Mexico City, Mexico
En Mxico, :	Mexico City, Mexico
En Mxico, Ao de M. DCC. XC. :	Mexico City, Mexico
En Mxico :	Mexico City, Mexico
En Mxico: :	Mexico City, Mexico
En Sanctiago Tlatilulco :	Mexico City, Mexico
Excudebat Mexici :	Mexico City, Mexico
Excussum opus Mexici :	Mexico City, Mexico
Fue imp[re]ssa e[n] esta muy leal ciudad d[e] Mexico :	Mexico City, Mexico
Fue impressa e[n] la ciudad de Mexico :	Mexico City, Mexico
Imp[re]ssa e[n] la misma ciudad d[e] Mexico :	Mexico City, Mexico
Imp[re]ssa e[n] Mexico :	Mexico City, Mexico
Impesso en Mxico :	Mexico City, Mexico
Impresa en Mexico, :	Mexico City, Mexico
Impresa en Mexico :	Mexico City, Mexico
Impresa en Mxico :	Mexico City, Mexico
Impresa en Mxico con licencia del Sr. Provisor :	Mexico City, Mexico
Impresas en Mexico :	Mexico City, Mexico
Impresas en Mxico, :	Mexico City, Mexico
Impresas en Mxico :	Mexico City, Mexico
Impreso con las licencias mecesarias en Mxico :	Mexico City, Mexico
Impreso con las licencias necesarias en Mexico :	Mexico City, Mexico
Impreso con las licencias necessarias en Mexico :	Mexico City, Mexico
Impreso en Mexico, :	Mexico City, Mexico
Impreso en Mexico :	Mexico City, Mexico
Impreso en Mxico 	Mexico City, Mexico
Impreso en Mxico,	Mexico City, Mexico
Impreso en Mxico, :	Mexico City, Mexico
Impreso en Mxico :	Mexico City, Mexico
Impreso en öMxico :	Mexico City, Mexico
Impressa: en Mexico :	Mexico City, Mexico
Impressa con las licencias necessarias en Mexico :	Mexico City, Mexico
Impressa en Lima, y por su original en Mexico :	Mexico City, Mexico
Impressa en Mexico, :	Mexico City, Mexico
Impressa en Mexico,  :	Mexico City, Mexico
Impressa en Mexico, con licencia del Superior Gobierno :	Mexico City, Mexico
Impressa en Mexico :	Mexico City, Mexico
Impressa en Mexico con las licencias necessarias: :	Mexico City, Mexico
Impressa en Mxico :	Mexico City, Mexico
Impressas con las licencias necessarias en Mxico :	Mexico City, Mexico
Impressas en Mexico,con las licensias necessarias :	Mexico City, Mexico
Impressas en Mexico :	Mexico City, Mexico
Impresso, con las licencias necessarias: en Mexico :	Mexico City, Mexico
Impresso: en Mexico :	Mexico City, Mexico
Impresso con las licencias necessarias en Mexico :	Mexico City, Mexico
Impresso con las licencias necessarias en Mexico: :	Mexico City, Mexico
Impresso Conlicencia, y aprobacion en Mexico :	Mexico City, Mexico
Impresso con licencia en Mexico, :	Mexico City, Mexico
Impresso con licencia en Mexico :	Mexico City, Mexico
"Impresso con licencia en Mexico: :;""o de 1654."""	Mexico City, Mexico
Impresso con licentia, en Mexico :	Mexico City, Mexico
Impresso de orden de su excelencia en Mxico :	Mexico City, Mexico
Impresso en Mexico, :	Mexico City, Mexico
Impresso en Mexico, con licencia :	Mexico City, Mexico
Impresso en Mexico :	Mexico City, Mexico
Impresso en Mexico  :	Mexico City, Mexico
Impresso en Mexico: :	Mexico City, Mexico
Impresso en Mexico. :	Mexico City, Mexico
Impresso en Mexico (con las licencias necessarias) :	Mexico City, Mexico
Impresso en Mexico con las licencias necessarias :	Mexico City, Mexico
Impresso en Mexico con licencia :	Mexico City, Mexico
Impresso en Mxico :	Mexico City, Mexico
Impresso en Mxico :	Mexico City, Mexico
Impressos en Mexico :	Mexico City, Mexico
Imprimiose ... en ... Mexico :	Mexico City, Mexico
Imprimio se e[n] la muy gra[n]de & insigne y muy leal ciudad de Mexico, :	Mexico City, Mexico
Inpresso [sic] en Mexico :	Mexico City, Mexico
Iuxta eius exemplar: Mexici, M. DCC. XXVII :	Mexico City, Mexico
La qual fue empressa en Mexico :	Mexico City, Mexico
Mexici, :	Mexico City, Mexico
Mexici, Anno M.D.CCLXI :	Mexico City, Mexico
Mexici, M. DCC. LIII. :	Mexico City, Mexico
Mexici :	Mexico City, Mexico
Mexici. :	Mexico City, Mexico
Mexici M. DCC. LXXXVIII :	Mexico City, Mexico
Mexico,	Mexico City, Mexico
Mexico, :	Mexico City, Mexico
Mexico :	Mexico City, Mexico
Mexico: :	Mexico City, Mexico
Mexico. :	Mexico City, Mexico
Mxico :	Mexico City, Mexico
Mxico: :	Mexico City, Mexico
Reimperesso [sic] en Mexico, :	Mexico City, Mexico
Reimpresa de orden del Exmo. Sr. virrey de esta N. Espaa en Mxico :	Mexico City, Mexico
Reimpresa en Mexico, :	Mexico City, Mexico
Reimpresa en Mexico :	Mexico City, Mexico
Reimpresa en Mxico, :	Mexico City, Mexico
Reimpresa en Mxico :	Mexico City, Mexico
Reimpresa en Mxico: :	Mexico City, Mexico
Reimpresas en Mxico, :	Mexico City, Mexico
Reimpresas en Mxico :	Mexico City, Mexico
Reimpreso en Mexico, :	Mexico City, Mexico
Reimpreso en Mexico :	Mexico City, Mexico
Reimpreso en Mexico: :	Mexico City, Mexico
Reimpreso en Mexico tercera vez. :	Mexico City, Mexico
Reimpreso en Mxico, :	Mexico City, Mexico
Reimpreso en Mxico, :En la Imprenta de la Calle de San Bernardo,	Mexico City, Mexico
Reimpreso en Mxico :	Mexico City, Mexico
Reimpresos en Mexico :	Mexico City, Mexico
Reimpresos en Mxico :	Mexico City, Mexico
Reimpressa, en Mexico, :	Mexico City, Mexico
Reimpressa. En Mexico: :	Mexico City, Mexico
Reimpressa con licencia en Mexico :	Mexico City, Mexico
Reimpressa con licencia en Mexico: :	Mexico City, Mexico
Reimpressa en Mexico,	Mexico City, Mexico
Reimpressa en Mexico, 	Mexico City, Mexico
Reimpressa en Mexico, :	Mexico City, Mexico
Reimpressa en Mexico :	Mexico City, Mexico
Reimpressa en Mexico: :	Mexico City, Mexico
Reimpressa en Mxico, :	Mexico City, Mexico
Reimpressa en Mxico :	Mexico City, Mexico
Reimpressa en Mxico :	Mexico City, Mexico
Reimpressas: en Mexico :	Mexico City, Mexico
Reimpressas en Mexico :	Mexico City, Mexico
Reimpressas en Mxico, :	Mexico City, Mexico
Reimpressas en Mxico :	Mexico City, Mexico
Reimpresso: en Mexico :	Mexico City, Mexico
Reimpresso con licencia, en Mexico :	Mexico City, Mexico
Reimpresso con licencia en Mexico :	Mexico City, Mexico
Reimpresso en Mexico, :	Mexico City, Mexico
Reimpresso en Mexico :	Mexico City, Mexico
Reimpresso en Mexico: :	Mexico City, Mexico
Reimpresso en Mxico, con licencia de los superiores :	Mexico City, Mexico
Reimpressos en Mexico, :	Mexico City, Mexico
Reimpressos en Mexico :	Mexico City, Mexico
Reimpresssa en Mexico :	Mexico City, Mexico
Rempresso en Mexico, :	Mexico City, Mexico
Se imprimio en ... Tenuchtitlan Mexico ... :	Mexico City, Mexico
Superiorum permissu: Mexici :	Mexico City, Mexico
Y por su original en Mexico, :	Mexico City, Mexico
Middleborough,	Middleborough, Massachusetts
Middleborough [Mass.] :	Middleborough, Massachusetts
Middleborough [Mass.]: :	Middleborough, Massachusetts
Middleborough: (County of Plymouth,)	Middleborough, Rhode Island
[Middletown, Conn.? :	Middletown, Connecticut
Middletown, [Conn.] :	Middletown, Connecticut
Middletown [Conn.], :	Middletown, Connecticut
Middletown [Conn.] :	Middletown, Connecticut
Middletown [Conn.]: :	Middletown, Connecticut
Monmouth, N. J.,	Monmouth, New Jersey
Monmouth (N.J.) :	Monmouth, New Jersey
[Montral? :	Montreal, Quebec
[Montreal? :	Montreal, Quebec
A Montral :	Montreal, Quebec
A Montreal :	Montreal, Quebec
Monti-regali [i.e., Montral] :	Montreal, Quebec
[Mount-Holly, N.J.] :	Mount Holly, New Jersey
Nassau, Bahamas,	Nassau, Bahamas
Newark, N.J. :	Newark, New Jersey
Newark, New-Jersey, :	Newark, New Jersey
Newark, New-Jersey:	Newark, New Jersey
Newark, New-Jersey :	Newark, New Jersey
Newark (N.J.) :	Newark, New Jersey
Newark [N.J.] :	Newark, New Jersey
Newark [N.J.]: :	Newark, New Jersey
[New Bedford, Mass.,	New Bedford, Massachusetts
[Newbedford, Massachusetts,	New Bedford, Massachusetts
[New Bedford] :	New Bedford, Massachusetts
Newbedford, (Massachusetts) :	New Bedford, Massachusetts
New Bedford, Mass. :	New Bedford, Massachusetts
New Bedford :	New Bedford, Massachusetts
Newbedford (Mass.),	New Bedford, Massachusetts
Newbedford (Massa.) :	New Bedford, Massachusetts
New Bedford (Massachusetts)	New Bedford, Massachusetts
New-Bedford [Mass.]: :	New Bedford, Massachusetts
Printed at Newbedford, (Massachusetts) :	New Bedford, Massachusetts
Printed at Newbedford, Massachusetts :	New Bedford, Massachusetts
Printed at New Bedford, Massachusetts :	New Bedford, Massachusetts
[Newbern, N.C.?] :	Newbern, North Carolina
Newbern [N.C] :	Newbern, North Carolina
[Newbern, N.C. :	New Bern, North Carolina
[New Bern, N.C. :	New Bern, North Carolina
Newbern, [N.C.] :	New Bern, North Carolina
New Bern, N.C. :	New Bern, North Carolina
Newbern [N.C.] :	New Bern, North Carolina
[New Brunswick, N.J.] :	New Brunswick, New Jersey
[New Jersey :	New Brunswick, New Jersey
New-Brunswick, New-Jersey: :	New Brunswick, New Jersey
New-Brunswick: [N.J.] :	New Brunswick, New Jersey
New-Brunswick [N.J.] :	New Brunswick, New Jersey
New-Brunswick [N.J.]: :	New Brunswick, New Jersey
Newburgh :	Newburgh, New York
Newburgh [N.Y.]:	Newburgh, New York
Newburgh [N.Y.] :	Newburgh, New York
Newbury [Mass.] :	Newbury, Massachusetts
Newbury [Mass.]: :	Newbury, Massachusetts
Newbury, (Vermont) :	Newbury, Vermont
[Newburyport, Ma.,	Newburyport, Massachusetts
[Newburyport, Mass.,	Newburyport, Massachusetts
[Newburyport, Mass.? :	Newburyport, Massachusetts
[Newburyport, Mass.]	Newburyport, Massachusetts
[Newburyport, Mass.] :	Newburyport, Massachusetts
[Newbury Port, Mass.] :	Newburyport, Massachusetts
[Newbury-Port, Mass.] :	Newburyport, Massachusetts
[Newburyport, Mass] :	Newburyport, Massachusetts
[Newburyport] :	Newburyport, Massachusetts
Newbury [i.e., Newburyport, Mass.]: :	Newburyport, Massachusetts
Newbury [i.e., Newburyport, Mass] :	Newburyport, Massachusetts
Newburyport,	Newburyport, Massachusetts
Newbury-port,	Newburyport, Massachusetts
Newbury-Port,	Newburyport, Massachusetts
Newbury-port, [Mass.]	Newburyport, Massachusetts
Newburyport, [Mass.] :	Newburyport, Massachusetts
Newburyport, Mass. :	Newburyport, Massachusetts
Newburyport, Massachusetts. :	Newburyport, Massachusetts
Newbury-Port, New-England: :	Newburyport, Massachusetts
Newburyport:	Newburyport, Massachusetts
Newburyport :	Newburyport, Massachusetts
Newbury-port:	Newburyport, Massachusetts
Newbury-port :	Newburyport, Massachusetts
Newbury-Port :	Newburyport, Massachusetts
Newbury-port: :	Newburyport, Massachusetts
Newbury-Port: [Mass.] :	Newburyport, Massachusetts
Newbury-Port. [Mass] :	Newburyport, Massachusetts
Newburyport (Massachusetts) :	Newburyport, Massachusetts
Newburyport [Mass.]	Newburyport, Massachusetts
Newbury-Port [Mass.]	Newburyport, Massachusetts
Newburyport [Mass.] :	Newburyport, Massachusetts
Newburyport [Mass.]-- :	Newburyport, Massachusetts
Newbury Port [Mass.] :	Newburyport, Massachusetts
Newbury-port [Mass.]:	Newburyport, Massachusetts
Newbury-port [Mass.] :	Newburyport, Massachusetts
Newbury-Port [Mass.] :	Newburyport, Massachusetts
Newburyport [Mass.]: :	Newburyport, Massachusetts
Newbury-port [Mass.]: :	Newburyport, Massachusetts
Newbury-Port [Mass.]: :	Newburyport, Massachusetts
Newburyport [Mass.]. :	Newburyport, Massachusetts
Newbury-port [Mass] :	Newburyport, Massachusetts
Newbury-Port [Mass] :	Newburyport, Massachusetts
Newbury-port [Massachusetts]	Newburyport, Massachusetts
Newbury-Port [Newburyport, Mass.] :	Newburyport, Massachusetts
Newbuyry-Port [sic] [Mass.] :	Newburyport, Massachusetts
Newbuyyport [sic] [Mass.]: :	Newburyport, Massachusetts
Printed at Newburyport, :	Newburyport, Massachusetts
Printed at Newburyport, ... :	Newburyport, Massachusetts
Printed at Newburyport, [Mass.] :	Newburyport, Massachusetts
Printed at Newburyport :	Newburyport, Massachusetts
"Printed at Newburyport [Mass.],;""Philadelphia,"""	Newburyport, Massachusetts
Printed at Newburyport [Mass.], :	Newburyport, Massachusetts
Printed at Newburyport [Mass.] :	Newburyport, Massachusetts
Printed in Newburyport [Mass.] :	Newburyport, Massachusetts
Re-printed at Newburyport [Mass.], :	Newburyport, Massachusetts
Re-printed at Newburyport [Mass.] :	Newburyport, Massachusetts
New-Castle [Del.] :	New Castle, Delaware
New-Castle [Del.]: :	New Castle, Delaware
[New England?	New England, U.S. (state not known)
[New England? :	New England, U.S. (state not known)
New England	New England, U.S. (state not known)
New England,	New England, U.S. (state not known)
New-England :	New England, U.S. (state not known)
Newfield [Conn.] :	Newfield, Connecticut
Printed at Newfield [Conn.], :	Newfield, Connecticut
Printed at Newfield [Conn.] :	Newfield, Connecticut
[New Haven, Conn.? :	New Haven, Connecticut
[New Haven, Conn.] :	New Haven, Connecticut
[New Haven :	New Haven, Connecticut
[New Haven? :	New Haven, Connecticut
[New Haven?] :	New Haven, Connecticut
[New Haven] :	New Haven, Connecticut
New Haven 	New Haven, Connecticut
New Haven,	New Haven, Connecticut
New-Haven,	New Haven, Connecticut
New-Haven, :	New Haven, Connecticut
New Haven, Conn. :	New Haven, Connecticut
New Haven, Ct. :	New Haven, Connecticut
New Haven :	New Haven, Connecticut
New-Haven :	New Haven, Connecticut
New-Haven  :	New Haven, Connecticut
New-Haven-- :	New Haven, Connecticut
New Haven: :	New Haven, Connecticut
New-Haven: :	New Haven, Connecticut
New-Haven.	New Haven, Connecticut
New-Haven. :	New Haven, Connecticut
New Haven [Conn.] :	New Haven, Connecticut
New-Haven [Conn.]  :	New Haven, Connecticut
Novi-Portus :	New Haven, Connecticut
Novo-Portu :	New Haven, Connecticut
Printed at New-Haven, :	New Haven, Connecticut
Printed at New-Haven :	New Haven, Connecticut
[New London, Conn?] :	New London, Connecticut
[New London, Conn. :	New London, Connecticut
[New London, Conn.? :	New London, Connecticut
[New-London, Conn.? :	New London, Connecticut
[New London, Conn.?] :	New London, Connecticut
[New-London, Conn.]	New London, Connecticut
[New London, Conn.] :	New London, Connecticut
[New-London, Conn.] :	New London, Connecticut
[New London :	New London, Connecticut
[New London? :	New London, Connecticut
[New London [Conn.] :	New London, Connecticut
[New London] :	New London, Connecticut
N. London,	New London, Connecticut
N. London [Conn.]	New London, Connecticut
N. London [Conn.], :	New London, Connecticut
N. London [i.e., New London, Conn.],  	New London, Connecticut
N. London [i.e., New London, Conn.], :	New London, Connecticut
N. London [i.e., New London, Conn.] :	New London, Connecticut
N. London [i.e., New London, Conn.]  :	New London, Connecticut
N. London [i.e., New London, Conn.]: :	New London, Connecticut
N. London [i.e. New London, Conn.] :	New London, Connecticut
N. London [i.e. New London, Conn.]  :	New London, Connecticut
N. London [New London, Conn.] :	New London, Connecticut
New-L[ondon,]	New London, Connecticut
New London,	New London, Connecticut
New-London,	New London, Connecticut
New-London, :	New London, Connecticut
New-London, (Conn.)	New London, Connecticut
New-London, (Conn.) :	New London, Connecticut
New London, Conn.,	New London, Connecticut
New London, Conn. :	New London, Connecticut
New-London, N.E. :	New London, Connecticut
New London :	New London, Connecticut
New-London:	New London, Connecticut
New-London :	New London, Connecticut
New-London: :	New London, Connecticut
New-London:-- :	New London, Connecticut
New London: (Connecticut). :	New London, Connecticut
New London [Conn. :	New London, Connecticut
New London [Conn.]	New London, Connecticut
New-London [Conn.], :	New London, Connecticut
New London [Conn.] :	New London, Connecticut
New-London [Conn.] :	New London, Connecticut
New-London [Conn.]: :	New London, Connecticut
New-London [Conn.] in N.E. :	New London, Connecticut
New-London [Conn] :	New London, Connecticut
New-London [Conn]: :	New London, Connecticut
New-London printed:	New London, Connecticut
N London [i.e., new London, Conn.] :	New London, Connecticut
N London [i.e., New London, Conn.] :	New London, Connecticut
N London [i.e. New London, Conn.] :	New London, Connecticut
Novi-Londini [Conn.] :	New London, Connecticut
Printed at New-London, (Connecticut.) :	New London, Connecticut
Printed at New London, Connecticut.	New London, Connecticut
[New Orleans :	New Orleans, Louisiana
[New Orleans] :	New Orleans, Louisiana
A la Nouvelle Orlans :	New Orleans, Louisiana
A la Nouvelle Orleans :	New Orleans, Louisiana
Nouvelle-Orleans,	New Orleans, Louisiana
(Newport [R.I.] :	Newport, Rhode Island
[Newport,	Newport, Rhode Island
[Newport, R.I.:	Newport, Rhode Island
[Newport, R.I. :	Newport, Rhode Island
[Newport, R.I.? :	Newport, Rhode Island
[Newport, R.I.]	Newport, Rhode Island
[Newport, R.I.] :	Newport, Rhode Island
[Newport, Rhode Island] :	Newport, Rhode Island
[Newport, Rhode-Island] :	Newport, Rhode Island
[Newport, RI] :	Newport, Rhode Island
[Newport :	Newport, Rhode Island
[Newport?	Newport, Rhode Island
[Newport? :	Newport, Rhode Island
[Newport?]	Newport, Rhode Island
[Newport? R.I.,	Newport, Rhode Island
[Newport] :	Newport, Rhode Island
[Rhode Island :	Newport, Rhode Island
#N/A	Newport, Rhode Island
A Newport :	Newport, Rhode Island
"Bristol:;""Newport:"""	Newport, Rhode Island
"London printed  ;""Newport [R.I.] :"""	Newport, Rhode Island
Newport	Newport, Rhode Island
Newport,	Newport, Rhode Island
Newport, :	Newport, Rhode Island
Newport, (Rhode-Island) :	Newport, Rhode Island
Newport, [R.I. :	Newport, Rhode Island
Newport, [R.I.] :	Newport, Rhode Island
Newport, [R.I.] June [i.e. July] 13, 1776 :	Newport, Rhode Island
Newport, R.I.,	Newport, Rhode Island
Newport, R. I.,	Newport, Rhode Island
Newport, R.I. :	Newport, Rhode Island
Newport, R. I. :	Newport, Rhode Island
Newport, Rhode Island,	Newport, Rhode Island
Newport, Rhode-Island,	Newport, Rhode Island
Newport, Rhode Island:	Newport, Rhode Island
Newport, Rhode Island :	Newport, Rhode Island
Newport, Rhode-Island :	Newport, Rhode Island
Newport, Rhode Island: :	Newport, Rhode Island
Newport, Rhode-Island: :	Newport, Rhode Island
Newport:	Newport, Rhode Island
Newport :	Newport, Rhode Island
Newport: :	Newport, Rhode Island
Newport (Rhode Island) :	Newport, Rhode Island
Newport (Rhode-Island) :	Newport, Rhode Island
Newport (Rhode Island) :bPrinted by Peter Edes,	Newport, Rhode Island
Newport [R.I.] :	Newport, Rhode Island
Newport [R.I.]: :	Newport, Rhode Island
Newporti [R.I.] :	Newport, Rhode Island
Newport N.E. :	Newport, Rhode Island
Newport Rhode-Island :	Newport, Rhode Island
Newport Rhode-Island: :	Newport, Rhode Island
Philadelphia-Printed:   Newport :	Newport, Rhode Island
Published at Newport :	Newport, Rhode Island
[[New York]	New York, New York
[New York	New York, New York
[New York,	New York, New York
[New York, N.Y. :	New York, New York
[New York, N.Y.] :	New York, New York
[New York :	New York, New York
[New-York :	New York, New York
[New York?	New York, New York
[New York? :	New York, New York
[New York?]	New York, New York
[New York?] :	New York, New York
[New York?] America :	New York, New York
[New York]	New York, New York
[New York] :	New York, New York
[New-York] :	New York, New York
"[New York] :;""New-York:"""	New York, New York
[New York] America :	New York, New York
[New York] Newport--printed. New-York:--reprinted :	New York, New York
Boston [i.e., New York? :	New York, New York
Brooklyn [New York, N.Y.]: :	New York, New York
"London, printed,;""New York,"""	New York, New York
London: printed, and, New-York, re-printed :	New York, New York
N.Y.,	New York, New York
N. York :	New York, New York
N[ew] York :	New York, New York
Neo-Eboraci [i.e. New York] :	New York, New York
New Yokk [sic] :	New York, New York
New York	New York, New York
New-York	New York, New York
New York,	New York, New York
New-York,	New York, New York
"New-York,;""Boston,"""	New York, New York
New York, :	New York, New York
New-York, :	New York, New York
New York, N.Y.,	New York, New York
"New York  ;""London :"""	New York, New York
"New York  ;""London  "";""and Paris :"""	New York, New York
New York:	New York, New York
New York :	New York, New York
New York  :	New York, New York
New-York:	New York, New York
New-York :	New York, New York
New-York-- :	New York, New York
--New-York :	New York, New York
"New York :;""London :"""	New York, New York
New York: :	New York, New York
New-York: :	New York, New York
New York. :	New York, New York
New-York. :	New York, New York
New Yorr [sic] :	New York, New York
Niew-York :	New York, New York
Niew-York: :	New York, New York
"Philadelphia, printed:  ;""New York, :"""	New York, New York
Printed at New-York, :	New York, New York
Printed at New-York :	New York, New York
Printed in New-York :	New York, New York
Te Nieuw-York, :	New York, New York
Te Nieuw-York :	New York, New York
Te Nieu-York, :	New York, New York
Waterford [New York] : :	New York, New York
[Norfolk, Va. :	Norfolk, Virginia
[Norfolk, Va.] :	Norfolk, Virginia
Norfolk, Virginia :	Norfolk, Virginia
Norfolk [Va.] :	Norfolk, Virginia
[Northampton, Mass.] :	Northampton, Massachusetts
Northampton, (Massachusetts) :	Northampton, Massachusetts
Northampton :	Northampton, Massachusetts
Northampton.	Northampton, Massachusetts
Northampton [Mass.],	Northampton, Massachusetts
Northampton [Mass.] :	Northampton, Massachusetts
Northampton [Mass.]: :	Northampton, Massachusetts
Printed, typographically, at Northampton, Massachusetts. :	Northampton, Massachusetts
Printed at Northampton, (Massachusetts) :	Northampton, Massachusetts
Printed at Northampton, Massachusetts,	Northampton, Massachusetts
Printed at Northampton, Massachusetts. :	Northampton, Massachusetts
Printed at Northampton :	Northampton, Massachusetts
Printed at Northampton [Mass.], :	Northampton, Massachusetts
Printed at Northampton [Mass.] :	Northampton, Massachusetts
Printed at Northampton [Mass.]: :	Northampton, Massachusetts
Northampton:	North Hampton, New Hampshire
Northumberland [Pa.] :	Northumberland, Pennsylvania
Northumberland-Town [Pa.] :	Northumberland, Pennsylvania
Printed at Northumberland: reprinted at Salem [Mass.]	Northumberland, Pennsylvania
[Norton, Mass.?	Norton, Massachusetts
[Norwich, Conn. :	Norwich, Connecticut
[Norwich, Conn.? :	Norwich, Connecticut
[Norwich, Conn.] :	Norwich, Connecticut
[Norwich] :	Norwich, Connecticut
Norwich,	Norwich, Connecticut
Norwich :	Norwich, Connecticut
Norwich: :	Norwich, Connecticut
Norwich (Conn.)	Norwich, Connecticut
Norwich (Connecticut)	Norwich, Connecticut
Norwich (Connecticut) :	Norwich, Connecticut
Norwich [Conn.]	Norwich, Connecticut
Norwich [Conn.], :	Norwich, Connecticut
Norwich [Conn.]:	Norwich, Connecticut
Norwich [Conn.]: 	Norwich, Connecticut
Norwich [Conn.] :	Norwich, Connecticut
Norwich [Conn.]: :	Norwich, Connecticut
Norwich [Conn] :	Norwich, Connecticut
Printed, in Norwich, (Connecticut,) :	Norwich, Connecticut
Printed at Norwich [Conn.] :	Norwich, Connecticut
Printed at Norwich [Conn.]: :	Norwich, Connecticut
[Oaxaca? :	Oaxaca, Mexico
Peacham, Vermont, :	Peacham, Vermont
Petersburg, Va.,	Petersburg, Virginia
Petersburg:	Petersburg, Virginia
Petersburg [Va.] :	Petersburg, Virginia
(Philadelphia :	Philadelphia, Pennsylvania
[2nd ed., Philadelphia :	Philadelphia, Pennsylvania
[Philadelphia	Philadelphia, Pennsylvania
[Philadelphia,	Philadelphia, Pennsylvania
[Philadelphia, :	Philadelphia, Pennsylvania
[Philadelphia, Pa. :	Philadelphia, Pennsylvania
[Philadelphia, Printed for H. & P. Rice, and Mathew Carey,	Philadelphia, Pennsylvania
[Philadelphia:	Philadelphia, Pennsylvania
[Philadelphia: 	Philadelphia, Pennsylvania
[Philadelphia :	Philadelphia, Pennsylvania
[Philadelphia?	Philadelphia, Pennsylvania
[Philadelphia? :	Philadelphia, Pennsylvania
[Philadelphia?] :	Philadelphia, Pennsylvania
[Philadelphia]	Philadelphia, Pennsylvania
[Philadelphia]: 	Philadelphia, Pennsylvania
[Philadelphia] :	Philadelphia, Pennsylvania
[Philadelphia]: :	Philadelphia, Pennsylvania
[Philadelphia] America :	Philadelphia, Pennsylvania
[Philadelphia] London, printed :	Philadelphia, Pennsylvania
[S.l. :	Philadelphia, Pennsylvania
[S.l.] :	Philadelphia, Pennsylvania
America :	Philadelphia, Pennsylvania
America [Philadelphia] :	Philadelphia, Pennsylvania
A Philadelphi :	Philadelphia, Pennsylvania
"A Philadelphia,  ;""et se trouve  Paris :"""	Philadelphia, Pennsylvania
"A Philadelphie,  ;""et se trouve  Paris, :"""	Philadelphia, Pennsylvania
"A Philadelphie,  ;""et se trouve  Paris :"""	Philadelphia, Pennsylvania
A Philadelphie, :	Philadelphia, Pennsylvania
A Philadelphie, et se trouve a Paris, :	Philadelphia, Pennsylvania
A Philadelphie :	Philadelphia, Pennsylvania
A Philadelphie  :	Philadelphia, Pennsylvania
A Philadelphie. :	Philadelphia, Pennsylvania
A Philadelphie. [i.e. Paris?] :	Philadelphia, Pennsylvania
A Philadelphie. [i.e. Paris or Brussels? :	Philadelphia, Pennsylvania
A Philadelphie [i.e. Paris?], et se trouve, a Paris, :	Philadelphia, Pennsylvania
A Philadelphie [U.S.] :	Philadelphia, Pennsylvania
Argraphwyd yn Philadelphia :	Philadelphia, Pennsylvania
ç Philadelphie :	Philadelphia, Pennsylvania
Ë Philadelphia,	Philadelphia, Pennsylvania
Ë Philadelphie :	Philadelphia, Pennsylvania
Filadelfia :	Philadelphia, Pennsylvania
Filadelfia [i.e. s.l.] :	Philadelphia, Pennsylvania
"London: Printed, and;""Philadelphia:"""	Philadelphia, Pennsylvania
Phiiladelphia [sic]: :	Philadelphia, Pennsylvania
Phil.,	Philadelphia, Pennsylvania
Phila.,	Philadelphia, Pennsylvania
Philad. :	Philadelphia, Pennsylvania
Philad[elphi]a :	Philadelphia, Pennsylvania
Philad[elphia]	Philadelphia, Pennsylvania
Philada. :	Philadelphia, Pennsylvania
Philadelahia [sic] :	Philadelphia, Pennsylvania
Philadelhpia [sic] :	Philadelphia, Pennsylvania
Philadelpaia [sic] :	Philadelphia, Pennsylvania
Philadelphi¾ :	Philadelphia, Pennsylvania
Philadelphia	Philadelphia, Pennsylvania
Philadelphia 	Philadelphia, Pennsylvania
Philadelphia,	Philadelphia, Pennsylvania
"Philadelphia,;""London,"""	Philadelphia, Pennsylvania
Philadelphia, :	Philadelphia, Pennsylvania
Philadelphia, : bgedruckt bey Henrich Miller, in der Zweyten-Strasse.,	Philadelphia, Pennsylvania
Philadelphia, Pa. :	Philadelphia, Pennsylvania
"Philadelphia, printed ;""London,"""	Philadelphia, Pennsylvania
"Philadelphia, printed ;""London, re-printed,"""	Philadelphia, Pennsylvania
"Philadelphia, printed:;""London,"""	Philadelphia, Pennsylvania
"Philadelphia ;""Boston "";""Reprinted by John Gill and Powars and Willis, in Queen-Street"""	Philadelphia, Pennsylvania
"Philadelphia  ;""London :"""	Philadelphia, Pennsylvania
Philadelphia:	Philadelphia, Pennsylvania
PHILADELPHIA:	Philadelphia, Pennsylvania
Philadelphia: 	Philadelphia, Pennsylvania
Philadelphia:  	Philadelphia, Pennsylvania
Philadelphia :	Philadelphia, Pennsylvania
Philadelphia  :	Philadelphia, Pennsylvania
"Philadelphia :;""and sold by John Dickins, no. 182, Race Street, near Sixth Street,"""	Philadelphia, Pennsylvania
"Philadelphia :;""Baltimore :"""	Philadelphia, Pennsylvania
Philadelphia::	Philadelphia, Pennsylvania
Philadelphia: :	Philadelphia, Pennsylvania
Philadelphia :$bPrinted by B. Franklin and D. Hall, at the New-printing-office ...,	Philadelphia, Pennsylvania
Philadelphia :bPrinted for John Ormrod, by W.W. Woodward ...,	Philadelphia, Pennsylvania
Philadelphia. :	Philadelphia, Pennsylvania
Philadelphia [etc.]	Philadelphia, Pennsylvania
Philadelphia [Pa.] :	Philadelphia, Pennsylvania
Philadelphia [Penn.]	Philadelphia, Pennsylvania
Philadelphiae :	Philadelphia, Pennsylvania
Philadelphiae: :	Philadelphia, Pennsylvania
Philadelphiae: [Philadelphia] :	Philadelphia, Pennsylvania
"Philadelphia printed,;""London,"""	Philadelphia, Pennsylvania
"Philadelphia printed ;""London,"""	Philadelphia, Pennsylvania
Philadelphie,	Philadelphia, Pennsylvania
Philadelphie, :	Philadelphia, Pennsylvania
Philadelphie:	Philadelphia, Pennsylvania
Philadelphie :	Philadelphia, Pennsylvania
Philadelphie  :	Philadelphia, Pennsylvania
Philadelphie. :	Philadelphia, Pennsylvania
Philadelphie [i.e., Philadelphia, Pa. :	Philadelphia, Pennsylvania
Philadelphie [Philadelphia, Pa. :	Philadelphia, Pennsylvania
Philadelpia:	Philadelphia, Pennsylvania
Philadelpohia :	Philadelphia, Pennsylvania
Philladephia [Philadelphia] :	Philadelphia, Pennsylvania
Philladephia [sic] :	Philadelphia, Pennsylvania
PPiladelphia [sic] :	Philadelphia, Pennsylvania
Printed at Philadelphia, :	Philadelphia, Pennsylvania
Printed at Philadelphia :	Philadelphia, Pennsylvania
Printed in Philadelphia :	Philadelphia, Pennsylvania
Te Philadelphia :	Philadelphia, Pennsylvania
United States. [Philadelphia? :	Philadelphia, Pennsylvania
United States [Philadelphia?]	Philadelphia, Pennsylvania
United States [Philadelphia] :	Philadelphia, Pennsylvania
Pittsfield, Mass.,	Pittsfield, Massachusetts
Pittsfield [Mass.] :	Pittsfield, Massachusetts
Pittsfield [Mass.]: :	Pittsfield, Massachusetts
[Plymouth, Mass.] :	Plymouth, Massachusetts
Plymouth: Massachusetts,	Plymouth, Massachusetts
Plymouth: Massachusetts. :	Plymouth, Massachusetts
A la Pointe--Pitre-Guadeloupe :	Pointe-a-Pitre, Guadeloupe
[Port-au-Prince, Haiti :	Port-au-Prince, Haiti
[Port-au-Prince, Haiti? :	Port-au-Prince, Haiti
[Port-au-Prince, Haiti?] :	Port-au-Prince, Haiti
[Port-au-Prince, Haiti] :	Port-au-Prince, Haiti
[Port-au-Prince :	Port-au-Prince, Haiti
[Port-au-Prince? :	Port-au-Prince, Haiti
[Port-au-Prince] :	Port-au-Prince, Haiti
Au Port-au-Prince, :	Port-au-Prince, Haiti
Au Port-au-Prince, [Haiti] :	Port-au-Prince, Haiti
Au port-au-Prince :	Port-au-Prince, Haiti
Au Port-au-Prince :	Port-au-Prince, Haiti
Au Port-au-Prince., :	Port-au-Prince, Haiti
Au Port-au-Prince [Haiti] :	Port-au-Prince, Haiti
Au Port-Republicain :	Port-au-Prince, Haiti
Au Port-Rpublicain [i.e. Port-au-Prince, Haiti] :	Port-au-Prince, Haiti
Au Port-Rpublicain [i.e. Port-au-Prince] :	Port-au-Prince, Haiti
Au Port-Rpublicain [Port-au-Prince] :	Port-au-Prince, Haiti
Port-au-Prince,	Port-au-Prince, Haiti
Port-au-Prince :	Port-au-Prince, Haiti
Port-au-Prince [Haiti] :	Port-au-Prince, Haiti
[Portland, Me. :	Portland, Maine
[Portland, Me.? :	Portland, Maine
[Portland, Me.] :	Portland, Maine
[Portland] :	Portland, Maine
0	Portland, Maine
District of Maine: Portland, :	Portland, Maine
District of Maine: Printed at Portland, :	Portland, Maine
Maine: Portland, :	Portland, Maine
Portland,	Portland, Maine
Portland, Me.	Portland, Maine
Portland [Me.]	Portland, Maine
Portland [Me.], :	Portland, Maine
Portland [Me.] :	Portland, Maine
Portland [Me.]: :	Portland, Maine
Printed at Portland [Me.], :	Portland, Maine
Printed at Portland [Me.] :	Portland, Maine
[Port Royal, Jamaica? :	Port Royal, Jamaica
[Portsmouth, N.H?	Portsmouth, New Hampshire
[Portsmouth, N.H. :	Portsmouth, New Hampshire
[Portsmouth, N.H.? :	Portsmouth, New Hampshire
[Portsmouth, N.H.] :	Portsmouth, New Hampshire
[Portsmouth? :	Portsmouth, New Hampshire
[Portsmouth] New-Hampshire, :	Portsmouth, New Hampshire
[Portsmouth] New-Hampshire :	Portsmouth, New Hampshire
New-Hampshire: Portsmouth, :	Portsmouth, New Hampshire
Portsmouth,	Portsmouth, New Hampshire
Portsmouth, (N.H.) :	Portsmouth, New Hampshire
Portsmouth, (New-Hampshire,) :	Portsmouth, New Hampshire
Portsmouth, (New Hampshire) :	Portsmouth, New Hampshire
Portsmouth, (New-Hampshire) :	Portsmouth, New Hampshire
Portsmouth, [N.H.]	Portsmouth, New Hampshire
Portsmouth, [N.H.] :	Portsmouth, New Hampshire
Portsmouth, in New-Hampshire, N.E. :	Portsmouth, New Hampshire
Portsmouth, in New-Hampshire :	Portsmouth, New Hampshire
Portsmouth, in New-Hampshire  :	Portsmouth, New Hampshire
Portsmouth, in New-Hampshire: :	Portsmouth, New Hampshire
Portsmouth, N.H.,	Portsmouth, New Hampshire
Portsmouth, N.H. :	Portsmouth, New Hampshire
Portsmouth, New Hampshire,	Portsmouth, New Hampshire
Portsmouth, New-Hampshire,	Portsmouth, New Hampshire
Portsmouth, New-Hampshire, :	Portsmouth, New Hampshire
Portsmouth, New-Hampshire:	Portsmouth, New Hampshire
Portsmouth, New-Hampshire :	Portsmouth, New Hampshire
Portsmouth, New-Hampshire  :	Portsmouth, New Hampshire
Portsmouth, New-Hampshire: :	Portsmouth, New Hampshire
Portsmouth :	Portsmouth, New Hampshire
Portsmouth: New-Hampshire, :	Portsmouth, New Hampshire
Portsmouth: -- New-Hampshire, :	Portsmouth, New Hampshire
Portsmouth:--New-Hampshire, :	Portsmouth, New Hampshire
Portsmouth: New-Hampshire :	Portsmouth, New Hampshire
Portsmouth:--New-Hampshire :	Portsmouth, New Hampshire
Portsmouth (N.H.)	Portsmouth, New Hampshire
Portsmouth [N.H.], :	Portsmouth, New Hampshire
Portsmouth [N.H.]:	Portsmouth, New Hampshire
Portsmouth [N.H.] :	Portsmouth, New Hampshire
Portsmouth [N.H.]: :	Portsmouth, New Hampshire
Portsmouth and Exeter, N. H.,	Portsmouth, New Hampshire
Portsmouth in New-Hampshire: :	Portsmouth, New Hampshire
Portsmouth  New-Hampshire, :	Portsmouth, New Hampshire
Portsmouth--New-Hampshire :	Portsmouth, New Hampshire
Printed at Portsmouth, in the state of New-Hampshire :	Portsmouth, New Hampshire
Printed at Portsmouth, New-Hampshire, :	Portsmouth, New Hampshire
State of New-Hampshire, Portsmouth :	Portsmouth, New Hampshire
State of New Hampshire: Portsmouth :	Portsmouth, New Hampshire
State of New-Hampshire: Portsmouth: :	Portsmouth, New Hampshire
[Potosi?	Potosi, Bolivia
[Poughkeepsie, N.Y.?] :	Poughkeepsie, New York
Poughkeepsie [N.Y.] :	Poughkeepsie, New York
Pownalborough [Me.]: :	Pownalborough, Maine
[Princeton, N.J.] :	Princeton, New Jersey
Princeton [N.J.] :	Princeton, New Jersey
(Providence :	Providence, Rhode Island
[Providence 	Providence, Rhode Island
[Providence,	Providence, Rhode Island
[Providence, R.I. :	Providence, Rhode Island
[Providence, R.I.? :	Providence, Rhode Island
[Providence, R.I.] :	Providence, Rhode Island
[Providence:	Providence, Rhode Island
[Providence :	Providence, Rhode Island
[Providence?	Providence, Rhode Island
[Providence? :	Providence, Rhode Island
[Providence?] :	Providence, Rhode Island
[Providence]	Providence, Rhode Island
[Providence] :	Providence, Rhode Island
America: Printed at Providence (R. Island) :	Providence, Rhode Island
America: Providence (Rhode-Island) :	Providence, Rhode Island
America [i.e. Providence, R.I.] :	Providence, Rhode Island
America-Providence (Rhode-Island) :	Providence, Rhode Island
"London,;""Providence,"""	Providence, Rhode Island
"Newport, R.I.,;""Providence, R.I.,"""	Providence, Rhode Island
"Philadelphia,;""Providence,"""	Providence, Rhode Island
Printed, at Providence :	Providence, Rhode Island
Printed at Providence,	Providence, Rhode Island
Printed at Providence, :	Providence, Rhode Island
Printed at Providence:	Providence, Rhode Island
Printed at Providence :	Providence, Rhode Island
Printed at Providence (R.I.) :	Providence, Rhode Island
Printed at Providence (R. Island) :	Providence, Rhode Island
Printed at Providence (Rhode-Island) :	Providence, Rhode Island
Printed in Providence, :	Providence, Rhode Island
Providence	Providence, Rhode Island
Providence,	Providence, Rhode Island
"Providence,;""Newport,"""	Providence, Rhode Island
Providence, :	Providence, Rhode Island
Providence, (New-England) :	Providence, Rhode Island
Providence, [R. I.] :	Providence, Rhode Island
Providence, in New-England,	Providence, Rhode Island
Providence, in New England :	Providence, Rhode Island
Providence, in New-England:	Providence, Rhode Island
Providence, in New-England :	Providence, Rhode Island
Providence, in New England: :	Providence, Rhode Island
Providence, in New-England: :	Providence, Rhode Island
Providence, New-England :	Providence, Rhode Island
Providence, R.I.,	Providence, Rhode Island
Providence, R.I. :	Providence, Rhode Island
Providence, Rhode Island:	Providence, Rhode Island
Providence, Rhode-Island :	Providence, Rhode Island
Providence, Rhode-Island: :	Providence, Rhode Island
Providence:	Providence, Rhode Island
Providence :	Providence, Rhode Island
Providence: :	Providence, Rhode Island
Providence (New-England)	Providence, Rhode Island
Providence (R.I.)	Providence, Rhode Island
Providence (R. I.)	Providence, Rhode Island
Providence (R.I.) :	Providence, Rhode Island
Providence (R. Island)	Providence, Rhode Island
Providence (Rhode-Island:) :	Providence, Rhode Island
Providence (Rhode-Island)	Providence, Rhode Island
Providence (Rhode Island) :	Providence, Rhode Island
Providence (Rhode-Island) :	Providence, Rhode Island
Providence [R.I.]	Providence, Rhode Island
Providence [R.I.] :	Providence, Rhode Island
Providence [R.I.]: :	Providence, Rhode Island
Providence [Rhode Island]	Providence, Rhode Island
Providentiae: :	Providence, Rhode Island
Re-printed at Providence, :	Providence, Rhode Island
Reprinted at Providence, :\	Providence, Rhode Island
Reprinted at Providence :	Providence, Rhode Island
Rhode-Island :	Providence, Rhode Island
State of Rhode-Island, &c. Printed at Providence :	Providence, Rhode Island
[Mexico City or Puebla, Mexico :	Puebla, Mexico
[Puebla, Mexico :	Puebla, Mexico
[Puebla, Mexico] :	Puebla, Mexico
[Puebla :	Puebla, Mexico
[Puebla? :	Puebla, Mexico
[Puebla] :	Puebla, Mexico
[Puebla de los Angeles, Mexico] :	Puebla, Mexico
[Puebla de los Angeles :	Puebla, Mexico
[Puebla de los Angeles] :	Puebla, Mexico
[Puebla de Zaragoza, Mexico :	Puebla, Mexico
[Puebla de Zaragoza, Mexico] :	Puebla, Mexico
[Puebla de Zaragoza] :	Puebla, Mexico
Angelopoli :	Puebla, Mexico
Angelopoli [i.e. Puebla de los Angeles] :	Puebla, Mexico
Angelopoli [Puebla, Mexico] :	Puebla, Mexico
Con licencia, en la Puebla :	Puebla, Mexico
Con licencia, y por su original, en la Puebla :	Puebla, Mexico
Con licencia: en la Puebla :	Puebla, Mexico
Con licencia del Ordinario: en la Puebla :	Puebla, Mexico
Con licencia de los superiores. En la Puebla :	Puebla, Mexico
Con licencia en la Puebla :	Puebla, Mexico
Con licencia en la Puebla de los Angeles :	Puebla, Mexico
Con lie[]cia en la Puebla :	Puebla, Mexico
En dicha Ciudad [Puebla] :	Puebla, Mexico
En la Ciudad de los Angeles, :	Puebla, Mexico
En la Puebla, :	Puebla, Mexico
En la Puebla :	Puebla, Mexico
En la Puebla  :	Puebla, Mexico
En  la Puebla :	Puebla, Mexico
En la Puebla de los Angeles, :	Puebla, Mexico
En la Puebla de los Angeles, [Mexico] :	Puebla, Mexico
En la Puebla de los Angeles :	Puebla, Mexico
En La Puebla de los Angeles :	Puebla, Mexico
Impresa en la Puebla de los Angeles :	Puebla, Mexico
Impreso con las licencias necesarias en la Puebla :	Puebla, Mexico
Impreso en la Puebla :	Puebla, Mexico
Impreso en la Puebla de los Angeles :	Puebla, Mexico
Impressa con licencia: en la Puebla :	Puebla, Mexico
Impresso en la Puebla de los Angeles, :	Puebla, Mexico
Impresso en la Puebla de los Angeles :	Puebla, Mexico
Imprsso [sic] en la Puebla,	Puebla, Mexico
Puebla :	Puebla, Mexico
Puebla de los Angeles, [Mexico] :	Puebla, Mexico
Puebla de los Angeles :	Puebla, Mexico
Puebla de Los Angeles :	Puebla, Mexico
"Puebla de los Angeles :;""y en Mxico en la de D. Felipe de Zuiga y Ontiveros, Calle del Espirito Santo,"""	Puebla, Mexico
Reimpr. Angelopoli: :	Puebla, Mexico
Reimpresa en la Puebla, de los Angeles :	Puebla, Mexico
Reimpresa en la Puebla :	Puebla, Mexico
Reimpresa en la Puebla de los Angeles :	Puebla, Mexico
Reimpresas en la Puebla de los Angeles :	Puebla, Mexico
Reimpresa  solicitud de un religioso franciscano descalzo del convento de S. Antonio y Santa Brbara de la ciudad de la Puebla de los Angeles :	Puebla, Mexico
Reimpreso en la Puebla :	Puebla, Mexico
Reimpreso en la Puebla de los Angeles :	Puebla, Mexico
Reimpressa: en la Puebla :	Puebla, Mexico
Reimpressa. En la Puebla :	Puebla, Mexico
Reimpressa en la Puebla :	Puebla, Mexico
Reimpressa en la Puebla de los Angeles :	Puebla, Mexico
Reimpressas en la Puebla :	Puebla, Mexico
Reimpresso: en la Puebla :	Puebla, Mexico
Reimpresso en la Puebla :	Puebla, Mexico
Reimpresso en La Puebla :	Puebla, Mexico
Reympresso en la Puebla :	Puebla, Mexico
Segunda impression en la Puebla :	Puebla, Mexico
[Putney, Vt.] :	Putney, Vermont
Putney [Vt.] :	Putney, Vermont
[Qubec :	Quebec, Quebec
[Qubec? ,	Quebec, Quebec
[Quebec, Quebec (Province)] :	Quebec, Quebec
[Quebec] :	Quebec, Quebec
A Qubec :	Quebec, Quebec
A Quebec :	Quebec, Quebec
Qubec :	Quebec, Quebec
Quebec,	Quebec, Quebec
Quebec :	Quebec, Quebec
"Uabistiguiatsh :;""Quebec :"""	Quebec, Quebec
Uabistiguiatsh. :	Quebec, Quebec
Uabistiguiatsh [i.e. Qubec City] :	Quebec, Quebec
[Quito :	Quito, Ecuador
Impresa en Quito :	Quito, Ecuador
Impreso en Quito :	Quito, Ecuador
Impreso  en Quito :	Quito, Ecuador
Quito :	Quito, Ecuador
[North Carolina?] :	Raleigh, North Carolina
[Reading, Pa.? :	Reading, Pennsylvania
[Reading?, Pa.,	Reading, Pennsylvania
Reading [Pa.] :	Reading, Pennsylvania
[Richmond, Va :	Richmond, Virginia
[Richmond, Va.? :	Richmond, Virginia
[Richmond :	Richmond, Virginia
"[Richmond :;""Philadelphia :"""	Richmond, Virginia
[Richmond (Va.) :	Richmond, Virginia
Richmond, Virginia :	Richmond, Virginia
Richmond:	Richmond, Virginia
Richmond :	Richmond, Virginia
Richmond: :	Richmond, Virginia
Richmond [Va.] :	Richmond, Virginia
Richmond [Va.]: :	Richmond, Virginia
Rio de Janeiro :	Rio de Janeiro, Brazil
Rochester,	Rochester, New York
[Dominica W.I.? :	Roseau, Dominica
Roxbury [Mass. :	Roxbury, Massachusetts
[Rutland, Vt.? :	Rutland, Vermont
[Rutland, Vt.] :	Rutland, Vermont
Printed at Rutland [Vt.] :	Rutland, Vermont
Rutland,	Rutland, Vermont
Rutland [Vt.] :	Rutland, Vermont
Rutland [Vt.]: :	Rutland, Vermont
State of Vermont. Printed at Rutland :	Rutland, Vermont
Sagg-Harbour [N.Y.] :	Sag Harbor, New York
Sag-Harbor [N.Y.] :	Sag Harbor, New York
Sag-Harbor [N.Y.]: :	Sag Harbor, New York
[A Saint-George Grenada :	Saint George, Grenada
[Saint George's, Grenada? :	Saint George, Grenada
[St. George?] :	Saint George, Grenada
A la Grenade [Saint George's?] :	Saint George, Grenada
Grenade, a Saint-George :	Saint George, Grenada
Brookville :	Saint John, New Brunswick
Fredericton :	Saint John, New Brunswick
Fredericton [i.e. Saint John] :	Saint John, New Brunswick
St. John :	Saint John, New Brunswick
St. John [N.B.] :	Saint John, New Brunswick
St John :	Saint John, New Brunswick
[Antigua :	Saint Johns, Antigua and Barbuda
[Antigua? :	Saint Johns, Antigua and Barbuda
[Antigua] :	Saint Johns, Antigua and Barbuda
[St. John?] :	Saint Johns, Antigua and Barbuda
Antigua :	Saint Johns, Antigua and Barbuda
St. John's, Antigua :	Saint Johns, Antigua and Barbuda
St. John's :	Saint Johns, Antigua and Barbuda
[Saint-Marc, Haiti? :	Saint-Marc, Haiti
[Saint-Marc, Haiti?] :	Saint-Marc, Haiti
A Saint-Marc :	Saint-Marc, Haiti
A Saint-Marc [Haiti] :	Saint-Marc, Haiti
[St. Mary's, Md.]	Saint Marys, Maryland
[Saint-Pierre, Martinique :	Saint Pierre, Martinique
[Saint Pierre, Martinique? :	Saint Pierre, Martinique
[Saint-Pierre, Martinique? :	Saint Pierre, Martinique
[St. Pierre, Martinique? :	Saint Pierre, Martinique
[Salem, Mass?	Salem, Massachusetts
[Salem, Mass. :	Salem, Massachusetts
[Salem, Mass.? :	Salem, Massachusetts
[Salem, Mass.] :	Salem, Massachusetts
[Salem, Massachusetts :	Salem, Massachusetts
[Salem? :	Salem, Massachusetts
[Salem] Massachusetts: :	Salem, Massachusetts
Marblehead [i.e., Salem, Mass.?] :	Salem, Massachusetts
Marblehead [i.e. Salem, Mass.]: :	Salem, Massachusetts
Printed at Salem [Mass.], :	Salem, Massachusetts
Printed at Salem [Mass.] :	Salem, Massachusetts
Salem,	Salem, Massachusetts
Salem, [Mass.]	Salem, Massachusetts
Salem, [Mass.] :	Salem, Massachusetts
Salem, [Mass.] New-England: :	Salem, Massachusetts
Salem, Mass :	Salem, Massachusetts
Salem, Mass.,	Salem, Massachusetts
Salem, New-England :	Salem, Massachusetts
Salem:	Salem, Massachusetts
Salem :	Salem, Massachusetts
Salem: :	Salem, Massachusetts
Salem: [Mass.] :	Salem, Massachusetts
Salem [Mass.]	Salem, Massachusetts
Salem [Mass.], New-England :	Salem, Massachusetts
Salem [Mass.], New-England: :	Salem, Massachusetts
Salem [Mass.]:	Salem, Massachusetts
Salem [Mass.] :	Salem, Massachusetts
Salem [Mass.]: :	Salem, Massachusetts
Salem [Mass.]: N.E. :	Salem, Massachusetts
Salem Mass :	Salem, Massachusetts
En el pueblo de S. Francisco Xavier [Paraguay] :	San Javier, Argentina
En el Pueblo de S. Maria la Mayor :	Santa Maria la Mayor, Argentina
En el pueblo de S. Maria la Mayor. [Paraguay :	Santa Maria la Mayor, Argentina
En el pueblo de S. Maria la Mayor. [Paraguay] :	Santa Maria la Mayor, Argentina
S. Paolo nel Brasile :	São Paulo, Brazil
[Savannah :	Savannah, Georgia
[Savannah] :	Savannah, Georgia
Savannah :	Savannah, Georgia
Schenectady [N.Y.] :	Schenectady, New York
Schenectady [N.Y.]: :	Schenectady, New York
[Scotch Plains, N.J.? :	Scotch Plains, New Jersey
[Sheffield, Mass.? :	Sheffield, Massachusetts
Shepherd's-Town [Va.] :	ShepherdsTown, Virginia
Shrewsbury,	Shrewsbury, Massachusetts
Shrewsbury, Mass. :	Shrewsbury, Massachusetts
St. Eustatius :	Sint Eustatius, Netherlands Antilles
[Southampton County, Va.] :	Southampton County, Virginia
[St. Jago de la Vega,	Spanish Town, Jamaica
Saint Jago de la Vega :	Spanish Town, Jamaica
St. Jago de la Vega, Jamaica :	Spanish Town, Jamaica
St Jago de la Vega [Spanish Town, Jamaica] :	Spanish Town, Jamaica
[Springfield, Mass.? :	Springfield, Massachusetts
[Springfield, Mass.] :	Springfield, Massachusetts
Commonwealth of Massachusetts. Springfield :	Springfield, Massachusetts
Printed at Springfield, (Massachusetts) :	Springfield, Massachusetts
Printed at Springfield, Massachusetts, :	Springfield, Massachusetts
Printed at Springfield, Massachusetts :	Springfield, Massachusetts
Springfield,	Springfield, Massachusetts
Springfield, (Massachusetts) :	Springfield, Massachusetts
Springfield, Massachusetts :	Springfield, Massachusetts
Springfield :	Springfield, Massachusetts
Springfield: (Massachusetts.) :	Springfield, Massachusetts
Springfield: <Massachusetts>	Springfield, Massachusetts
Springfield--(Massa.)-- :	Springfield, Massachusetts
Springfield [Mass.]	Springfield, Massachusetts
Springfield [Mass.] :	Springfield, Massachusetts
Springfield [Mass.]: :	Springfield, Massachusetts
St. Augustine, East-Florida :	St Augustine, Florida
St. Augustine, East-Florida: :	St Augustine, Florida
Staunton [Va.]: :	Staunton, Virginia
[Stockbridge, Mass.] :	Stockbridge, Massachusetts
Printed at Stockbridge [Mass.], :	Stockbridge, Massachusetts
Printed at Stockbridge [Mass.] :	Stockbridge, Massachusetts
Re-printed at Stockbridge, Massachusetts :	Stockbridge, Massachusetts
Stockbridge :	Stockbridge, Massachusetts
Stockbridge [Mass.]	Stockbridge, Massachusetts
Stockbridge [Mass.] :	Stockbridge, Massachusetts
Stockbridge [Mass.]: :	Stockbridge, Massachusetts
Stonington-Port [Conn.]	Stonington, Connecticut
Stonington-Port [Conn.], :	Stonington, Connecticut
Stonington-Port [Conn.] :	Stonington, Connecticut
Printed at Suffield [Conn.], :	Suffield, Connecticut
Printed at Suffield [Conn.] :	Suffield, Connecticut
Suffield [Conn.], :	Suffield, Connecticut
Suffield [Conn.] :	Suffield, Connecticut
Suffield [Conn.]: :	Suffield, Connecticut
Sutton, Mass. :	Sutton, Massachusetts
[Taunton, Mass.? :	Taunton, Massachusetts
Taunton	Taunton, Massachusetts
(Trenton :	Trenton, New Jersey
Trenton,	Trenton, New Jersey
Trenton, [N.J.] :	Trenton, New Jersey
Trenton, N.J. :	Trenton, New Jersey
Trenton:	Trenton, New Jersey
Trenton :	Trenton, New Jersey
Trenton: :	Trenton, New Jersey
Trenton [N.J.], :	Trenton, New Jersey
Trenton [N.J.] :	Trenton, New Jersey
[Troy, N.Y.] :	Troy, New York
Troy,	Troy, New York
Troy [N.Y.]	Troy, New York
Troy [N.Y.] :	Troy, New York
Union [i.e. Uniontown, Pa.] :	Uniontown, Pennsylvania
[Wallingford? Conn.,	Wallingford, Connecticut
Printed at Walpole, Newhampshire,	Walpole, New Hampshire
Printed at Walpole, Newhampshire, :	Walpole, New Hampshire
Printed at Walpole, Newhampshire :	Walpole, New Hampshire
Printed at Walpole, New Hampshire :	Walpole, New Hampshire
Walpole, N. H.	Walpole, New Hampshire
Walpole, N.H. :	Walpole, New Hampshire
Walpole, Newhampshire,	Walpole, New Hampshire
Walpole, Newhampshire, :	Walpole, New Hampshire
Walpole, Newhampshire :	Walpole, New Hampshire
Walpole, New Hampshire :	Walpole, New Hampshire
Walpole, Newhampshire. :	Walpole, New Hampshire
[R.I.] :	Warren, Rhode Island
[Warren, R.I.? :	Warren, Rhode Island
[Warren, R.I.] :	Warren, Rhode Island
[Warren] :	Warren, Rhode Island
Printed at Warren (R.I.) :	Warren, Rhode Island
Warren,	Warren, Rhode Island
Warren, R.I.	Warren, Rhode Island
Warren, R.I.,	Warren, Rhode Island
Warren, R.I. :	Warren, Rhode Island
Warren :	Warren, Rhode Island
Warren (R.I.) :	Warren, Rhode Island
Warren (R. Island) :	Warren, Rhode Island
Warren (Rhode Island) :	Warren, Rhode Island
Warren (Rhode-Island) :	Warren, Rhode Island
Warren [R.I.]	Warren, Rhode Island
Warren [R.I.] :	Warren, Rhode Island
[Warwick, Mass.,	Warwick, Massachusetts
[Warwick, Pa. :	Warwick, Pennsylvania
[Washington,	Washington, District of Columbia
[Washington, D.C.,	Washington, District of Columbia
[Washington, D.C. :	Washington, District of Columbia
[Washington]	Washington, District of Columbia
Washington City [D.C.] :	Washington, District of Columbia
Washington [Pa.] :	Washington, Pennsylvania
Washington [Pa.]: :	Washington, Pennsylvania
Waterford,	Waterford, New York
Waterford [N.Y.] :	Waterford, New York
[Watertown, Mass. :	Watertown, Massachusetts
[Watertown, Mass.? :	Watertown, Massachusetts
[Watertown, Mass.] :	Watertown, Massachusetts
Watertown: :	Watertown, Massachusetts
Watertown: New-England [i.e., Watertown, Mass.] :	Watertown, Massachusetts
Watertown [Mass.] :	Watertown, Massachusetts
Watertown [Mass.]: :	Watertown, Massachusetts
[Westminster, Vt. :	Westminster, Vermont
West-Springfied [sic] [Mass.] :	West Springfield, Massachusetts
West-Springfield [Mass.] :	West Springfield, Massachusetts
West-Springfield [Mass.]: :	West Springfield, Massachusetts
Whitehall :	Whitehall, Pennsylvania
Whitehall [Pa.] :	Whitehall, Pennsylvania
[Williamsburg, Va. :	Williamsburg, Virginia
[Williamsburg, Va.? :	Williamsburg, Virginia
[Williamsburg, Va.] :	Williamsburg, Virginia
[Williamsburg? :	Williamsburg, Virginia
Williamsburg :	Williamsburg, Virginia
Williamsburg: :	Williamsburg, Virginia
Williamsburg [Va.] :	Williamsburg, Virginia
Williamsburg [Va.]: :	Williamsburg, Virginia
[Wilmington, Del. :	Wilmington, Delaware
[Wilmington, Del.] :	Wilmington, Delaware
[Wilmington, Del] :	Wilmington, Delaware
Wilmington, :	Wilmington, Delaware
Wilmington, (Delaware): 	Wilmington, Delaware
Wilmington :	Wilmington, Delaware
Wilmington (DeL.)	Wilmington, Delaware
Wilmington (Delaware) :	Wilmington, Delaware
Wilmington [Del.]	Wilmington, Delaware
Wilmington [Del.], :	Wilmington, Delaware
Wilmington [Del.], Re-printed by James Adams, M,DCC,LXXXIII [i. e. 1783]	Wilmington, Delaware
Wilmington [Del.]:	Wilmington, Delaware
Wilmington [Del.] :	Wilmington, Delaware
Wilmington [Del.]: :	Wilmington, Delaware
Wilmingtonii :	Wilmington, Delaware
Wilmington,	Wilmington, Massachusetts
Wilmington, (North-Carolina) :	Wilmington, North Carolina
[Windham, Conn. :	Windham, Connecticut
[Windham, Conn.?	Windham, Connecticut
[Windham, Conn.] :	Windham, Connecticut
Printed at Windham, (Connecticut) :	Windham, Connecticut
Windham,	Windham, Connecticut
Windham, Conn. :	Windham, Connecticut
Windham [Conn.]	Windham, Connecticut
Windham [Conn.] :	Windham, Connecticut
Windham [Conn.]: :	Windham, Connecticut
[Windsor, Vt.? :	Windsor, Vermont
[Windsor, Vt.] :	Windsor, Vermont
[Windsor] :	Windsor, Vermont
Printed at Windsor, Vermont, :	Windsor, Vermont
Printed at Windsor, Vermont :	Windsor, Vermont
Printed at Windsor [Vt.], :	Windsor, Vermont
Windsor, [Vt.] :	Windsor, Vermont
Windsor [Vt.] :	Windsor, Vermont
Windsor [Vt.]: :	Windsor, Vermont
Wiscasset [Me.] :	Wiscasset, Maine
Wiscasset [Me.]: :	Wiscasset, Maine
Woodbridge, in New Jersey :	Woodbridge, New Jersey
Woodbridge, in New-Jersey :	Woodbridge, New Jersey
[Worcester, Mass. :	Worcester, Massachusetts
[Worcester, Mass.? :	Worcester, Massachusetts
[Worcester, Mass.] :	Worcester, Massachusetts
[Worcester] :	Worcester, Massachusetts
Massachusetts. Worcester, :	Worcester, Massachusetts
Massachusetts-Bay: Worcester, :	Worcester, Massachusetts
Massachusetts-Bay: Worcester :	Worcester, Massachusetts
Massachusetts-Bay [Worcester] :	Worcester, Massachusetts
Printed, typographically, at Worcester, Massachusetts, :	Worcester, Massachusetts
Printed at Worcester,	Worcester, Massachusetts
Printed at Worcester, :	Worcester, Massachusetts
Printed at Worcester, (Massachusetts,) :	Worcester, Massachusetts
Printed at Worcester, (Massachusetts) :	Worcester, Massachusetts
Printed at Worcester, Mass.,	Worcester, Massachusetts
Printed at Worcester, Massachusetts,	Worcester, Massachusetts
Printed at Worcester, Massachusetts, :	Worcester, Massachusetts
Printed at Worcester, Massachusetts :	Worcester, Massachusetts
Printed at Worcester, Massachusetts. :	Worcester, Massachusetts
Printed at Worcester :	Worcester, Massachusetts
Printed at Worcester [Mass.], :	Worcester, Massachusetts
Printed at Worcester [Mass.] :	Worcester, Massachusetts
Printed in Worcester, Massachusetts :	Worcester, Massachusetts
Published at Worcester [Mass.] :	Worcester, Massachusetts
United States of America.	Worcester, Massachusetts
United States of America. Printed at the press in Worcester, Massachusetts :	Worcester, Massachusetts
United States of Columbia. Printed at Worcester, Massachusetts :	Worcester, Massachusetts
United States of Columbia. Printed at Worcester, Massachusetts. :	Worcester, Massachusetts
Wigorni¾, Massachusettensis, :	Worcester, Massachusetts
Wigorniae (Worcester) Massachusetts,	Worcester, Massachusetts
Worcester,	Worcester, Massachusetts
Worcester, (Massachusetts:) :	Worcester, Massachusetts
Worcester, (Massachusetts) :	Worcester, Massachusetts
Worcester, Mass :	Worcester, Massachusetts
Worcester, Mass.,	Worcester, Massachusetts
Worcester, Mass. :	Worcester, Massachusetts
Worcester, Massachusetts,	Worcester, Massachusetts
Worcester, Massachusetts :	Worcester, Massachusetts
Worcester:	Worcester, Massachusetts
Worcester :	Worcester, Massachusetts
Worcester: Massachusetts-Bay, :	Worcester, Massachusetts
Worcester: Massachusetts-Bay :	Worcester, Massachusetts
Worcester [Mass.]	Worcester, Massachusetts
Worcester [Mass.] :	Worcester, Massachusetts
Worcester [Mass.]: :	Worcester, Massachusetts
Worcester [Mass.]. :	Worcester, Massachusetts
Worcester [Mass] :	Worcester, Massachusetts
Worcester  Massachusetts-Bay, :	Worcester, Massachusetts
[Wrentham, Mass.,	Wrentham, Massachusetts
[Wrentham, Mass.]	Wrentham, Massachusetts
[Wrentham, Mass.] :	Wrentham, Massachusetts
Printed at Wrentham, (Massachusetts:) :	Wrentham, Massachusetts
Printed at Wrentham, Massachusetts, :	Wrentham, Massachusetts
Printed at Wrentham, Massachusetts :	Wrentham, Massachusetts
Printed at Wrentham :	Wrentham, Massachusetts
Printed at Wrentham (Massachusetts) :	Wrentham, Massachusetts
Printed at Wrentham [Mass.], :	Wrentham, Massachusetts
Wrentham, (Mass.)	Wrentham, Massachusetts
Wrentham, (Mass.) :	Wrentham, Massachusetts
Wrentham, [Mass.]	Wrentham, Massachusetts
Wrentham, Mass. :	Wrentham, Massachusetts
York [Pa.] :	York, Pennsylvania
York-Town: (Pennsylvania) :	York, Pennsylvania
York-Town [i.e., York, Pa.] :	York, Pennsylvania
